Date,Open,High,Low,Close,Volume,boll_mavg,boll_hband,boll_lband,boll_hband_ind,boll_lband_ind,boll_bandwidth,RSI,daily_return,ROC,MACD,on_balance_volume,avg_close,max_close,min_close,max_close_pct,min_close_pct,boll_hband_num,boll_lband_num,pct_change,DX-Y.NYB_Open,DX-Y.NYB_High,DX-Y.NYB_Low,DX-Y.NYB_Close,DX-Y.NYB_Volume,DX-Y.NYB_boll_mavg,DX-Y.NYB_boll_hband,DX-Y.NYB_boll_lband,DX-Y.NYB_boll_hband_ind,DX-Y.NYB_boll_lband_ind,DX-Y.NYB_boll_bandwidth,DX-Y.NYB_RSI,DX-Y.NYB_daily_return,DX-Y.NYB_ROC,DX-Y.NYB_MACD,DX-Y.NYB_on_balance_volume,DX-Y.NYB_avg_close,DX-Y.NYB_max_close,DX-Y.NYB_min_close,DX-Y.NYB_max_close_pct,DX-Y.NYB_min_close_pct,DX-Y.NYB_boll_hband_num,DX-Y.NYB_boll_lband_num,BTC-USD_Open,BTC-USD_High,BTC-USD_Low,BTC-USD_Close,BTC-USD_Volume,BTC-USD_boll_mavg,BTC-USD_boll_hband,BTC-USD_boll_lband,BTC-USD_boll_hband_ind,BTC-USD_boll_lband_ind,BTC-USD_boll_bandwidth,BTC-USD_RSI,BTC-USD_daily_return,BTC-USD_ROC,BTC-USD_MACD,BTC-USD_on_balance_volume,BTC-USD_avg_close,BTC-USD_max_close,BTC-USD_min_close,BTC-USD_max_close_pct,BTC-USD_min_close_pct,BTC-USD_boll_hband_num,BTC-USD_boll_lband_num,day
2020-03-16,1563.800048828125,1574.800048828125,1450.9000244140625,1516.699951171875,535860,1632.7850036621094,1711.6472122181358,1553.922795106083,0.0,1.0,9.659839890634647,25.9516033280521,-4.628063597840237,-7.692777450683586,-6.6378407393799534,933354,1632.7850036621094,1675.699951171875,1516.699951171875,1.026283281273109,0.9289036509829085,0.0,1.0,0.9069002206593855,98.47000122070312,98.47000122070312,97.44999694824219,98.08999633789062,0.0,97.93850021362304,100.61761406173153,95.25938636551456,0.0,0.0,5.4710126094739335,53.13463680815054,-0.6683581388449378,-0.3555527172238305,-0.3374029889445751,0.0,97.93850021362304,99.87000274658203,94.9000015258789,1.0197215857782793,0.9689754419240996,0.0,0.0,5385.2294921875,5385.2294921875,4575.35791015625,5014.47998046875,45368026429,7747.8988037109375,10749.271645742541,4746.525961679335,0.0,0.0,77.47578841876624,20.145077317266427,-7.006915676163484,-42.72599619959997,-968.433865929771,-359360501166,7747.8988037109375,9122.5458984375,4970.7880859375,1.1774219216787087,0.6415659537985562,0.0,4.0,20
2020-03-17,1512.800048828125,1554.300048828125,1465.5999755859375,1486.5,415321,1626.7350036621094,1727.8529156044567,1525.6170917197621,0.0,1.0,12.432007882625065,22.820295717271904,-1.9911618740767412,-9.497716894977168,-17.214846531710464,518033,1626.7350036621094,1675.699951171875,1486.5,1.0301001376373753,0.9137935783354928,0.0,2.0,0.8870919874172217,98.13999938964844,99.83000183105469,97.9800033569336,99.58000183105469,0.0,97.94450035095215,100.63771789763152,95.25128280427279,0.0,0.0,5.4994768200952535,63.35305205139365,1.519018808025474,1.4776364192614033,-0.12130093998943892,0.0,97.94450035095215,99.87000274658203,94.9000015258789,1.0196591170380211,0.9689160819222694,0.0,0.0,5002.578125,5371.3486328125,4981.9091796875,5225.62939453125,38622642935,7568.154150390625,10717.959012248613,4418.349288532636,0.0,0.0,83.23839074275236,24.34529391975387,4.210793838741411,-42.4411721078543,-976.8396773806271,-320737858231,7568.154150390625,9122.5458984375,4970.7880859375,1.205385846688475,0.6568032293159537,0.0,4.0,21
2020-03-18,1527.5999755859375,1547.0,1473.300048828125,1525.800048828125,412332,1622.1950073242188,1732.464745290874,1511.9252693575636,0.0,0.0,13.595127277397195,34.28516934435255,2.643797432097217,-2.610576601675216,-21.34388388149,930365,1622.1950073242188,1675.699951171875,1486.5,1.0329830529659387,0.916350989423864,0.0,2.0,0.9189905462600372,99.37999725341797,101.73999786376953,99.1500015258789,101.16000366210938,0.0,98.02250061035156,100.98034477350916,95.06465644719395,1.0,0.0,6.03503102806019,70.84331297110793,1.5866657983550692,3.9030433729822582,0.1775678511464207,0.0,98.02250061035156,101.16000366210938,94.9000015258789,1.0320079882906648,0.96814507827254,1.0,0.0,5227.11376953125,5331.833984375,5069.3359375,5238.4384765625,37878801016,7390.8513671875,10644.333192842183,4137.369541532816,0.0,0.0,88.0407862103377,24.612566599763753,0.24512036855608432,-42.57701156143556,-965.038176982137,-282859057215,7390.8513671875,9122.5458984375,4970.7880859375,1.2343024430092113,0.6725596063270683,0.0,4.0,22
2020-03-19,1487.199951171875,1502.800048828125,1460.0999755859375,1477.9000244140625,306016,1613.860009765625,1740.1348618624477,1487.5851576688021,0.0,1.0,15.648798697869863,28.543110971290815,-3.1393382410003,-7.33007404282197,-28.178041195635842,624349,1613.860009765625,1675.699951171875,1477.9000244140625,1.0383180331825874,0.9157547838543274,0.0,3.0,0.8998964747450556,100.79000091552734,102.83999633789062,100.7699966430664,102.76000213623047,0.0,98.16700057983398,101.69849494365076,94.6355062160172,1.0,0.0,7.194870665208519,76.29487393531215,1.5816512615651313,5.774575936426687,0.5342616232765778,0.0,98.16700057983398,102.76000213623047,94.9000015258789,1.0467876325981993,0.9667199870154105,2.0,0.0,5245.41650390625,6329.73583984375,5236.96875,6191.19287109375,51000731797,7266.788256835937,10504.5207744379,4029.055739233974,0.0,0.0,89.11041310598797,41.64926378629305,18.187755736638024,-30.513751243589155,-857.101825611162,-231858325418,7266.788256835937,9122.5458984375,4970.7880859375,1.2553752188741476,0.6840419605265685,0.0,4.0,23
2020-03-20,1471.5999755859375,1519.4000244140625,1457.5,1479.300048828125,253577,1604.4500122070312,1740.9673113412255,1467.932713072837,0.0,0.0,17.01733280507821,28.929662191804155,0.09473065775322809,-10.040134586154997,-32.627947029640836,877926,1604.4500122070312,1675.699951171875,1477.9000244140625,1.0444077025913912,0.9211256275794529,0.0,3.0,0.9302018508508537,102.94000244140625,102.98999786376953,101.08999633789062,102.81999969482422,0.0,98.34500045776367,102.3991176598017,94.29088325572565,1.0,0.0,8.244683884625442,76.47811647140077,0.05838610095998398,5.629755047361189,0.7942509726835993,0.0,98.34500045776367,102.81999969482422,94.9000015258789,1.0455030679366606,0.9649702687899798,3.0,0.0,6191.65380859375,6844.26171875,5865.78173828125,6198.7783203125,54442976102,7146.751733398438,10355.829019660054,3937.6744471368224,0.0,0.0,89.80519838865675,41.765682627103224,0.1225199953657663,-23.54847711789559,-761.7025512767186,-177415349316,7146.751733398438,9122.5458984375,4970.7880859375,1.2764604450726496,0.6955310987938546,0.0,4.0,24
2020-03-23,1496.199951171875,1576.0,1488.199951171875,1575.699951171875,170446437,1592.0500061035157,1730.8774893867305,1453.2225228203008,0.0,0.0,17.440090795010903,51.056094870349064,5.355708537943538,-5.533576068832434,-27.398481171146614,172740328,1592.0500061035157,1675.699951171875,1477.9000244140625,1.0525422849456152,0.9283000023543035,0.0,3.0,1.060006694363858,101.94999694824219,102.9800033569336,101.6500015258789,102.48999786376953,0.0,98.50500030517578,102.93117947114924,94.07882113920233,0.0,0.0,8.986709613239572,73.02815219418613,-0.3209510134547289,5.856226179319455,0.9443857702453897,0.0,98.50500030517578,102.81999969482422,94.9000015258789,1.043804876669004,0.9634028854562883,3.0,0.0,5831.37451171875,6443.9345703125,5785.00439453125,6416.31494140625,46491915999,6757.338037109375,9723.275021016249,3791.4010532025013,0.0,0.0,87.78418269498411,47.27742262455352,10.052048673231173,-18.898166338519925,-543.8687327633479,-213517488936,6757.338037109375,9122.5458984375,4970.7880859375,1.3500206513776694,0.7356133522756073,0.0,4.0,26
2020-03-24,1590.9000244140625,1698.0,1578.800048828125,1696.0999755859375,230724452,1594.8550048828124,1739.5859168852865,1450.1240928803384,0.0,0.0,18.14972665971082,65.99883915772287,7.641050209116207,1.417122149360076,-11.65308900301602,403464780,1594.8550048828124,1696.0999755859375,1477.9000244140625,1.0634822415787977,0.9266673270543841,0.0,3.0,1.1116135281871367,102.12999725341797,102.20999908447266,101.05000305175781,101.73999786376953,0.0,98.6435001373291,103.28721953731491,93.99978073734329,0.0,0.0,9.41515536963092,65.5599134867291,-0.7317787253707464,6.034394059074972,0.9742364512067923,0.0,98.6435001373291,102.81999969482422,94.9000015258789,1.0423393285080182,0.962050225243036,3.0,0.0,6436.642578125,6789.02294921875,6411.06640625,6734.8037109375,48221910672,6656.31591796875,9477.261602822902,3835.3702331145987,0.0,0.0,84.75996991786397,51.893295714228294,4.963733427047878,35.487644906658765,-438.0251312640139,-165295578264,6656.31591796875,9122.5458984375,4970.7880859375,1.3705097550750487,0.7467776690885177,0.0,4.0,27
2020-03-25,1671.699951171875,1679.0,1615.199951171875,1638.0999755859375,135796364,1594.6050048828124,1739.0186363296452,1450.1913734359796,0.0,0.0,18.11277789855498,56.72856728317771,-3.4196097420473803,-2.2438370043301927,-4.817269017031549,267668416,1594.6050048828124,1696.0999755859375,1477.9000244140625,1.0636489728756269,0.926812608695326,0.0,3.0,1.1083970150385436,101.5999984741211,101.91000366210938,100.83999633789062,101.05000305175781,0.0,98.74600028991699,103.5057206142319,93.98627996560208,0.0,0.0,9.640330363438386,59.35510981727329,-0.6781942466085211,6.480507299256283,0.9197240027190787,0.0,98.74600028991699,102.81999969482422,94.9000015258789,1.0412573612394023,0.9610515995306516,3.0,0.0,6738.716796875,6892.51123046875,6536.92626953125,6681.06298828125,44590107887,6536.430932617188,9130.02259741939,3942.839267814985,0.0,0.0,79.35803778970639,51.055256086140034,-0.7979552925792555,20.082940218730627,-356.74139997259863,-209885686151,6536.430932617188,9122.5458984375,4970.7880859375,1.3956463385722384,0.7604743532335001,0.0,4.0,28
2020-03-26,1628.9000244140625,1672.4000244140625,1611.0,1636.5999755859375,101608789,1594.3100036621095,1738.3547128540717,1450.2652944701472,0.0,0.0,18.069849509956466,56.50051766093764,-0.09156950261619556,-1.4274572393655902,0.19655909410039385,166059627,1594.3100036621095,1696.0999755859375,1477.9000244140625,1.0638457838751672,0.926984100343939,0.0,3.0,1.1063340239070651,100.95999908447266,101.0199966430664,99.23999786376953,99.41999816894531,0.0,98.79500007629395,103.56128388456268,94.0287162680252,0.0,0.0,9.648836083988057,47.54410341494274,-1.6130676235384334,3.1220769551935117,0.7223187111237195,0.0,98.79500007629395,102.81999969482422,94.9000015258789,1.0407409242919377,0.9605749425840665,3.0,0.0,6675.1708984375,6735.4638671875,6590.962890625,6716.4404296875,35319797641,6416.125659179687,8726.473435810538,4105.777882548836,0.0,0.0,72.01691174253695,51.6266555462218,0.5295181540467819,29.153220316703205,-287.3300039602718,-174565888510,6416.125659179687,8909.9541015625,4970.7880859375,1.388681359258424,0.7747335931343065,0.0,4.0,29
2020-03-27,1639.699951171875,1647.199951171875,1611.4000244140625,1630.5999755859375,50347295,1597.5050048828125,1741.792826710365,1453.21718305526,0.0,0.0,18.06414645168977,55.50875778866103,-0.36661371682178423,-0.7124199533779574,3.385210049196303,115712332,1597.5050048828125,1696.0999755859375,1477.9000244140625,1.0617180981604233,0.9251301372432796,0.0,3.0,1.0902647781517316,99.29000091552734,99.80999755859375,98.2699966430664,98.37000274658203,0.0,98.80700035095215,103.56773181888468,94.04626888301962,0.0,0.0,9.636425457756857,41.61684411545003,-1.0561209431718344,1.9272620134502167,0.47277114335503256,0.0,98.80700035095215,102.81999969482422,94.9000015258789,1.0406145245743552,0.9604582791583998,3.0,0.0,6719.38916015625,6793.83642578125,6466.70166015625,6469.79833984375,34585598366,6294.11787109375,8302.824753366787,4285.410988820713,0.0,0.0,63.82806688442195,47.3450504325987,-3.672214358569481,19.981833593653295,-252.32642414609745,-209151486876,6294.11787109375,8108.1162109375,4970.7880859375,1.288205333455016,0.7897513500289294,0.0,4.0,30
2020-03-30,1645.5,1651.5999755859375,1607.199951171875,1637.199951171875,79971500,1600.6149963378907,1747.3929794818098,1453.8370131939716,0.0,0.0,18.340198421199116,55.04986565377187,-1.6224012013092204,7.944880588075177,9.967017434406443,36409226,1600.6149963378907,1696.0999755859375,1477.9000244140625,1.0596551822059088,0.9233326113996229,0.0,3.0,0.9652732590873867,98.30999755859375,99.31999969482422,98.29000091552734,99.18000030517578,0.0,98.89800033569335,103.61398424832304,94.18201642306367,0.0,0.0,9.537066263467478,47.25330282971873,0.8234192700801612,1.7543850036491473,0.3499842711040202,0.0,98.89800033569335,102.81999969482422,94.9000015258789,1.0396570137497045,0.9595745232841525,3.0,0.0,5925.53857421875,6517.19580078125,5903.234375,6429.841796875,37101651525,6026.747290039062,7465.370586114126,4588.123993963998,0.0,0.0,47.74128487029161,48.732399208365315,8.574723804008189,22.743482158719697,-220.6575340815425,-235308752182,6026.747290039062,7911.43017578125,4970.7880859375,1.3127197466628757,0.8247878742407468,0.0,3.0,32
2020-03-31,1637.199951171875,1641.5999755859375,1570.0,1592.4000244140625,79259106,1598.0849975585938,1743.5922901805036,1452.577704936684,0.0,0.0,18.210206946964938,47.911769850970224,-2.7363747919577963,7.1241186958669696,6.930474123457998,-42849880,1598.0849975585938,1696.0999755859375,1477.9000244140625,1.0613327690185952,0.924794379943408,0.0,3.0,0.9721018546773811,99.25,99.94999694824219,98.88999938964844,98.94999694824219,0.0,98.98800010681153,103.63531601932463,94.34068419429842,0.0,0.0,9.38965512486057,45.856523357000235,-0.23190497703758917,0.20252855518196203,0.233116048688359,0.0,98.98800010681153,102.81999969482422,94.9000015258789,1.038711758838221,0.9587020792770686,3.0,0.0,6430.6064453125,6504.51513671875,6374.162109375,6438.64453125,32786468812,5953.1080078125,7124.206621919802,4782.009393705197,0.0,0.0,39.34410773567096,48.89117843911038,0.13690436954885143,3.9968333293505465,-188.8343014152615,-202522283370,5953.1080078125,6734.8037109375,4970.7880859375,1.1313088393657817,0.8349904082731471,0.0,3.0,33
2020-04-01,1596.800048828125,1612.4000244140625,1571.5,1605.199951171875,85905097,1594.9449951171875,1736.9500539867129,1452.9399362476622,0.0,0.0,17.806891059474008,49.971139880341646,0.8038135243386701,5.203820933465842,5.670853917788008,43055217,1594.9449951171875,1696.0999755859375,1477.9000244140625,1.0634222376184939,0.9266150424864493,0.0,3.0,0.9808138672354431,99.01000213623047,99.83999633789062,98.91000366210938,99.66999816894531,0.0,99.10450019836426,103.69722238593948,94.51177801078904,0.0,0.0,9.268443266214108,50.90425309915486,0.7276414784325169,1.6107675502525811,0.20490433520883755,0.0,99.10450019836426,102.81999969482422,94.9000015258789,1.0374907243265759,0.9575750983651623,3.0,0.0,6437.3193359375,6612.57373046875,6202.37353515625,6606.7763671875,40346426265,6034.907421875,7147.190374377316,4922.624469372684,0.0,0.0,36.861640941518814,52.043210659525926,2.6112924097839496,6.581910592576756,-147.45011652199173,-162175857105,6034.907421875,6734.8037109375,5014.47998046875,1.1159746521587977,0.8309124945798736,0.0,2.0,34
2020-04-02,1598.699951171875,1645.5999755859375,1586.0,1637.699951171875,81969792,1593.2099914550781,1732.2032888995193,1454.216694010637,0.0,0.0,17.448208106892256,54.991373354496766,2.0246698846628775,10.81263442168003,7.454064000728749,125025009,1593.2099914550781,1696.0999755859375,1477.9000244140625,1.0645803030879124,0.9276241250937027,0.0,3.0,1.0043542105312409,99.51000213623047,100.41000366210938,99.33999633789062,100.18000030517578,0.0,99.27250022888184,103.7633523347795,94.78164812298418,0.0,0.0,9.047524934989223,54.26038278472289,0.5116907249922864,0.602529085246492,0.2246282416104748,0.0,99.27250022888184,102.81999969482422,94.9000015258789,1.0357349664586195,0.9559545826596314,3.0,0.0,6606.7763671875,7088.24755859375,6595.91845703125,6793.62451171875,47660646124,6096.403295898437,7233.404069512424,4959.40252228445,0.0,0.0,37.300707267150216,55.4368594525199,2.828128789998541,9.839152330746247,-98.08449326025129,-114515210981,6096.403295898437,6793.62451171875,5014.47998046875,1.1143659928616259,0.8225308820763896,0.0,1.0,35
2020-04-03,1634.800048828125,1652.800048828125,1619.800048828125,1648.800048828125,65942638,1591.8649963378907,1728.1332350876075,1455.596757588174,0.0,0.0,17.12057731820273,56.64245635707999,0.677785796372965,11.458121706564862,9.606075348369359,190967647,1591.8649963378907,1696.0999755859375,1477.9000244140625,1.065479785966675,0.92840789125585,0.0,3.0,0.9907463629397982,100.19999694824219,100.8499984741211,100.13999938964844,100.58000183105469,0.0,99.50400047302246,103.75693941719523,95.25106152884969,0.0,0.0,8.548277303334807,56.83198664239426,0.3992828155923167,-0.5733509391636507,0.2699715556616269,0.0,99.50400047302246,102.81999969482422,94.9000015258789,1.0333252854763442,0.9537305140973524,3.0,0.0,6797.396484375,7003.220703125,6673.3359375,6733.38720703125,38976504902,6173.054345703125,7263.853334764591,5082.25535664166,0.0,0.0,35.34065724921852,54.0663621752093,-0.8866740365705117,15.490443254567992,-65.05802807822329,-153491715883,6173.054345703125,6793.62451171875,5014.47998046875,1.1005288680874137,0.8123174849350187,0.0,0.0,36
2020-04-06,1641.9000244140625,1742.5999755859375,1626.5,1730.699951171875,89924751,1595.384991455078,1741.8016198971113,1448.9683630130448,0.0,0.0,18.35502141818362,66.66694696324845,4.967242838327168,15.719442325734953,18.12368437836085,280892398,1595.384991455078,1730.699951171875,1477.9000244140625,1.0848164928475241,0.9263594883553073,0.0,3.0,1.0571097011901782,100.66000366210938,100.93000030517578,100.4800033569336,100.69000244140625,0.0,99.79350051879882,103.5075559073984,96.07944513019925,0.0,0.0,7.4434815279376485,57.561053035378364,0.10936628390236791,-2.01440215238609,0.30838641577908277,0.0,99.79350051879882,102.81999969482422,96.41000366210938,1.0303276181343621,0.9660950178208041,3.0,0.0,6788.0498046875,7271.78125,6782.8896484375,7271.78125,46896904614,6437.955029296875,7306.034799276757,5569.875259316993,0.0,0.0,26.967562402332906,63.658826983879415,7.0776424294876294,8.841680773776336,51.09427052740102,-102919232542,6437.955029296875,7271.78125,5238.4384765625,1.1295172483977713,0.8136805014518126,0.0,0.0,37
2020-04-07,1707.0999755859375,1742.5999755859375,1672.0,1693.9000244140625,194263,1597.964990234375,1749.3322301895464,1446.5977502792034,0.0,0.0,18.945000782898294,59.76793418406288,-2.1263031025623436,7.501432817477724,20.928956549178338,280698135,1597.964990234375,1730.699951171875,1477.9000244140625,1.083064999389024,0.9248638320901497,0.0,3.0,1.0637402652875165,100.75,100.79000091552734,99.7699966430664,99.9800033569336,0.0,99.97200050354004,103.34603442708855,96.59796657999154,0.0,0.0,6.7499578012926404,51.34233561622196,-0.7051336451062484,-2.7621049857225253,0.2700115834306871,0.0,99.97200050354004,102.81999969482422,96.51000213623047,1.0284879684005455,0.965370320190932,3.0,0.0,7273.64404296875,7427.939453125,7136.71435546875,7176.41455078125,44243482667,6534.853833007813,7267.862342728755,5801.845323286871,0.0,0.0,22.433815000374953,61.003455423891616,-1.3114627068677276,6.84848061870105,84.56680807293742,-147162715209,6534.853833007813,7271.78125,5830.2548828125,1.1127687681811547,0.8921783152002032,0.0,0.0,38
2020-04-08,1683.0999755859375,1695.800048828125,1662.5,1680.699951171875,66999389,1602.4849853515625,1758.0085668275642,1446.9614038755608,0.0,0.0,19.410301238096412,57.40049465526842,-0.7792710934491853,-0.9079667847257873,21.500316939521554,213698746,1602.4849853515625,1730.699951171875,1477.9000244140625,1.0800100887011954,0.9222551461783788,0.0,3.0,1.0470346388590912,99.91000366210938,100.43000030517578,99.9000015258789,100.12000274658203,0.0,100.15250053405762,103.12925686720399,97.17574420091125,0.0,0.0,5.944447352333655,52.46743069885226,0.14002739042588974,-2.312416007987155,0.24904987402663892,0.0,100.15250053405762,102.81999969482422,97.47000122070312,1.0266343740450043,0.9732158528339261,3.0,0.0,7179.283203125,7356.2236328125,7153.3056640625,7334.0986328125,37563249548,6591.99912109375,7384.701472658222,5799.296769529277,0.0,0.0,24.05043863030572,63.77916319118274,2.197254365887824,13.358998960539834,121.53312118384656,-109599465661,6591.99912109375,7334.0986328125,5830.2548828125,1.1125757904524145,0.8844441232032718,0.0,0.0,39
2020-04-09,1684.300048828125,1754.5,1682.4000244140625,1740.5999755859375,90794733,1613.6799865722655,1775.0169255336907,1452.3430476108404,0.0,0.0,19.996150451631074,64.49208949253945,3.5639927503000823,6.257249345439764,26.7371214731661,304493479,1613.6799865722655,1740.5999755859375,1477.9000244140625,1.0786525147921502,0.9158569460561861,0.0,2.0,1.0628320372974496,100.12999725341797,100.30000305175781,99.36000061035156,99.5199966430664,0.0,100.25500030517578,102.9862830030678,97.52371760728377,0.0,0.0,5.448671267424069,47.26329103069263,-0.5992869427244529,-2.1820338778419477,0.1772716321456329,0.0,100.25500030517578,102.81999969482422,98.08999633789062,1.0255847526990234,0.9784050275727405,3.0,0.0,7337.96630859375,7341.4482421875,7179.09423828125,7302.08935546875,34815139177,6647.1646728515625,7475.491404480095,5818.83794122303,0.0,0.0,24.922708324395686,62.771408122862155,-0.43644459866604146,16.979535299283565,144.0219588910113,-144414604838,6647.1646728515625,7334.0986328125,5830.2548828125,1.1033424014251554,0.8771040240095908,0.0,0.0,40
2020-04-13,1730.300048828125,1772.800048828125,1730.0999755859375,1769.4000244140625,82922552,1638.4449829101563,1801.992075713301,1474.8978901070118,0.0,0.0,19.963696615879915,67.47391759371062,1.7949645678653203,8.512207218588285,34.4988948538612,386839246,1638.4449829101563,1769.4000244140625,1477.9000244140625,1.0799264197881748,0.9020138239790397,0.0,1.0,1.0223609373860463,99.48999786376953,99.62999725341797,99.13999938964844,99.5,0.0,100.29250030517578,102.9599485397722,97.62505207057936,0.0,0.0,5.319337391090572,47.09032939197899,-0.020093090575679096,-1.5338970855487266,0.1193361397146191,0.0,100.29250030517578,102.81999969482422,98.08999633789062,1.0252012800753558,0.9780391957466087,3.0,0.0,6965.61669921875,6965.61669921875,6668.259765625,6845.03759765625,38619308647,6765.877954101563,7464.960149984461,6066.795758218665,0.0,0.0,20.66493663129426,49.75476784177372,-1.8082418492216368,3.606315958446428,75.60737018322652,-222119272790,6765.877954101563,7334.0986328125,5922.04296875,1.0839832882835958,0.8752807852763559,0.0,0.0,42
2020-04-14,1780.5999755859375,1788.800048828125,1736.0,1751.300048828125,119041708,1652.1149841308593,1805.0610277927715,1499.168940468947,0.0,0.0,18.515181465093207,63.53982771768813,-1.0229442373796305,5.2337519656166895,35.707002225804445,267797538,1652.1149841308593,1769.4000244140625,1479.300048828125,1.0709908459216018,0.8953977556267682,0.0,0.0,1.0338863118169668,99.37999725341797,99.43000030517578,98.83000183105469,98.88999938964844,0.0,100.33250045776367,102.88829330027907,97.77670761524827,0.0,0.0,5.094645963879466,41.89387595468243,-0.6130659400518268,-0.5330907152062538,0.021568494815966233,0.0,100.33250045776367,102.81999969482422,98.37000274658203,1.0247925570050722,0.9804400597789569,3.0,0.0,6843.28173828125,6958.55712890625,6793.8212890625,6842.427734375,34110434051,6773.94619140625,7472.651271446605,6075.241111365895,0.0,0.0,20.629188963052744,49.678119102811685,-0.03812781513637953,0.7183679723844945,60.989051658711105,-256229706841,6773.94619140625,7334.0986328125,5922.04296875,1.0826921893942538,0.8742382654682118,0.0,0.0,43
2020-04-15,1754.4000244140625,1758.5,1724.0,1743.300048828125,99885419,1665.3149841308593,1800.9080337457376,1529.721934515981,0.0,0.0,16.28437273512498,61.77109131760019,-0.45680350465091557,6.480582752296423,35.290371713679406,167912119,1665.3149841308593,1769.4000244140625,1495.5999755859375,1.062501713654805,0.8980883435493151,0.0,0.0,1.0372464446212435,98.81999969482422,99.9800033569336,98.81999969482422,99.45999908447266,0.0,100.32650032043458,102.88988361988478,97.76311702098437,0.0,0.0,5.110082164259639,47.86685611024585,0.5763977129560782,1.1080576471047199,-0.0018278141037484374,0.0,100.32650032043458,102.81999969482422,98.37000274658203,1.0248538458575314,0.9804986960812582,3.0,0.0,6845.5615234375,6928.66455078125,6633.40283203125,6642.10986328125,32288311030,6770.229663085937,7470.906706737077,6069.552619434798,0.0,0.0,20.69876735412737,43.90930783860744,-2.9275847531044064,-1.355593268937287,31.768072887273775,-288518017871,6770.229663085937,7334.0986328125,5922.04296875,1.0832865349902392,0.8747181799517676,0.0,0.0,44
2020-04-16,1743.0999755859375,1768.0,1715.0,1730.0999755859375,99128838,1677.0399841308595,1790.6813269702907,1563.3986412914282,0.0,0.0,13.55260982621435,58.77172596694371,-0.7571888299470197,8.647321593865392,33.22800474713449,68783281,1677.0399841308595,1769.4000244140625,1575.699951171875,1.0550732487938081,0.939572083004625,0.0,0.0,0.9939675972956018,99.62999725341797,100.30000305175781,99.61000061035156,100.02999877929688,0.0,100.27000007629394,102.80708539181079,97.73291476077709,0.0,0.0,5.060507257577376,53.210914696642014,0.5730944098844226,0.8570260854059868,0.03023511372148846,0.0,100.27000007629394,102.81999969482422,98.37000274658203,1.0254313315706594,0.9810511885083651,2.0,0.0,6640.4541015625,7134.45068359375,6555.50439453125,7116.80419921875,46783242376,6802.5799560546875,7504.529483799503,6100.630428309872,0.0,0.0,20.63774427583289,57.04346649205227,7.146740203164859,3.629790505248034,50.68593893612615,-241734775495,6802.5799560546875,7334.0986328125,5922.04296875,1.078134866505278,0.8705583774107706,0.0,0.0,45
2020-04-17,1720.300048828125,1723.300048828125,1686.5,1694.5,125232803,1682.9799865722657,1786.8078742573093,1579.152098887222,0.0,0.0,12.338576633523779,51.30643432088973,-2.0576831448067434,5.563172909576253,28.043691838102404,-56449522,1682.9799865722657,1769.4000244140625,1592.4000244140625,1.0513494150443279,0.9461788239427089,0.0,0.0,0.9748590769764934,99.86000061035156,100.29000091552734,99.62000274658203,99.77999877929688,0.0,100.12099990844726,102.39168172249607,97.85031809439845,0.0,0.0,4.535875223230238,50.679226878637046,-0.24992502554318508,0.8388093548793506,0.03180143494759591,0.0,100.12099990844726,102.81999969482422,98.37000274658203,1.026957379459304,0.9825111898256472,1.0,0.0,7116.552734375,7167.18310546875,7050.33203125,7096.1845703125,32513423567,6845.2794921875,7508.509734081555,6182.049250293446,0.0,0.0,19.37774031435816,56.40599464963539,-0.2897315751431484,4.491965298539362,62.02714569147065,-274248199062,6845.2794921875,7334.0986328125,5922.04296875,1.071409668689626,0.8651280017870435,0.0,0.0,46
2020-04-20,1696.5,1718.4000244140625,1680.0,1707.699951171875,99271986,1686.1649841308595,1788.316951471189,1584.01301679053,0.0,0.0,12.116485433124346,53.93773898880277,1.0353804582627468,3.5722889737668773,20.982911768398708,42442267,1686.1649841308595,1769.4000244140625,1592.4000244140625,1.0493635208099799,0.9443915864703308,0.0,0.0,0.9751041532343787,99.70999908447266,100.06999969482422,99.6500015258789,99.95999908447266,0.0,99.97799987792969,101.8812770909051,98.07472266495428,0.0,0.0,3.8073920568510244,52.48767651993911,0.18039718117648373,0.29096109246011886,0.04799468729991929,0.0,99.97799987792969,102.48999786376953,98.37000274658203,1.0251255075007193,0.983916490294755,0.0,0.0,7186.87353515625,7240.29052734375,6835.5029296875,6881.95849609375,37747113935,6972.2054443359375,7414.179393477961,6530.231495193914,0.0,0.0,12.678167695160875,48.2179482442476,-4.276646838190478,-6.16490395555755,69.77004076781122,-310859334827,6972.2054443359375,7334.0986328125,6606.7763671875,1.0519051240480237,0.9475877353204927,0.0,0.0,48
2020-04-21,1705.4000244140625,1718.0,1659.9000244140625,1706.0,126145255,1689.6349853515626,1789.5059438635706,1589.7640268395546,0.0,0.0,11.821601633234152,53.53066862034983,-0.09954624468475615,-1.427165416810141,18.72157272979439,-83702988,1689.6349853515626,1769.4000244140625,1592.4000244140625,1.0472084442817708,0.942452090670182,0.0,0.0,0.9786037699860108,99.94000244140625,100.4800033569336,99.93000030517578,100.26000213623047,0.0,99.86650009155274,101.39182419434127,98.3411759887642,0.0,0.0,3.054726262340601,55.508748598452016,0.3001231037470298,0.07985808625571966,0.08512511343934648,0.0,99.86650009155274,101.73999786376953,98.37000274658203,1.0187600223348097,0.9850150216178719,0.0,0.0,6879.7841796875,6934.5517578125,6834.4423828125,6880.3232421875,32589741510,6985.882788085937,7397.67579254472,6574.089783627154,0.0,0.0,11.789290400379308,48.1705044030761,-0.023761461322069355,-5.775964833481213,52.15120443595424,-343449076337,6985.882788085937,7334.0986328125,6642.10986328125,1.0498456466118251,0.9507903388543859,0.0,0.0,49
2020-04-22,1703.0999755859375,1742.4000244140625,1695.4000244140625,1687.800048828125,187864,1692.4949890136718,1788.646623389389,1596.3433546379545,0.0,0.0,11.362117465618166,49.12072732854969,-1.066820115584699,-0.36011426282655284,15.147658054651401,-83890852,1692.4949890136718,1769.4000244140625,1592.4000244140625,1.0454388555946086,0.9408595208556918,0.0,0.0,0.9755505882002647,100.20999908447266,100.5,99.9000015258789,100.38999938964844,0.0,99.79900016784669,101.08787571741206,98.51012461828131,0.0,0.0,2.5829428098431517,56.83034660330775,0.12966013429895895,-0.18890677863120262,0.12239241856678973,0.0,99.79900016784669,101.05000305175781,98.37000274658203,1.0125352246195567,0.9856812451140663,0.0,0.0,6879.4404296875,7145.86572265625,6867.78173828125,7117.20751953125,33249153865,7002.061938476562,7407.750251030968,6596.373625922157,0.0,0.0,11.587681346408399,55.25662287672744,3.4429236680519004,3.6663696176459917,58.715099312074926,-310199922472,7002.061938476562,7334.0986328125,6642.10986328125,1.0474198453617476,0.948593417430748,0.0,0.0,50
2020-04-23,1737.5999755859375,1764.199951171875,1735.5,1747.5999755859375,100270320,1696.664990234375,1794.7607150552412,1598.5692654135087,0.0,0.0,11.563358162687788,60.88492320467509,3.5430693819053394,3.9804858902635285,17.417218632522463,16379468,1696.664990234375,1769.4000244140625,1592.4000244140625,1.0428694141732953,0.938547110702208,0.0,0.0,1.0313366630781573,100.44999694824219,100.69000244140625,100.04000091552734,100.43000030517578,0.0,99.76800003051758,100.96130918566591,98.57469087536926,0.0,0.0,2.392168139650612,57.26436502132804,0.03984551824935956,-0.25822040910344574,0.15132383767101487,0.0,99.76800003051758,100.69000244140625,98.37000274658203,1.00924146430325,0.9859875182071614,0.0,0.0,7121.30615234375,7491.78515625,7081.5947265625,7429.724609375,43500782316,7036.87880859375,7463.348032473701,6610.4095847138,0.0,0.0,12.120976798950338,62.72668870395987,4.391007132869618,8.319502780656522,89.6151314481931,-266699140156,7036.87880859375,7429.724609375,6642.10986328125,1.0558267111693738,0.943899993725856,0.0,0.0,51
2020-04-24,1746.0,1760.199951171875,1725.4000244140625,1745.699951171875,89027416,1702.089990234375,1798.4160824047658,1605.763898063984,0.0,0.0,11.318566318238785,60.391957756138936,-0.10872192953799154,0.29300101444737164,18.631181818689356,-72647948,1702.089990234375,1769.4000244140625,1592.4000244140625,1.0395455202520867,0.9355557188811102,0.0,0.0,1.0328363516763326,100.5,100.87000274658203,100.22000122070312,100.37999725341797,0.0,99.81599998474121,101.02656093668661,98.60543903279581,0.0,0.0,2.425584980625258,56.47573096363423,-0.04978895908182013,0.40007389783372665,0.16579100771855337,0.0,99.81599998474121,100.69000244140625,98.37000274658203,1.008756135857965,0.9855133722210845,0.0,0.0,7434.181640625,7574.19580078125,7434.181640625,7550.90087890625,34636526285,7071.0474853515625,7544.665220509329,6597.429750193796,1.0,0.0,13.39597099691146,65.22777913873043,1.6309658285092787,8.31733534610987,121.42885595082589,-232062613871,7071.0474853515625,7550.90087890625,6642.10986328125,1.0678617127870738,0.9393388853689778,1.0,0.0,52
2020-04-27,1742.300048828125,1745.800048828125,1717.0,1720.300048828125,80903668,1715.2949951171875,1783.652077903089,1646.9379123312858,0.0,0.0,7.9703004999710325,53.37973215883958,-1.2116673532858724,-2.77495054303489,16.83276253998588,-153820650,1715.2949951171875,1769.4000244140625,1637.699951171875,1.0315426964171714,0.9547628576039707,0.0,0.0,1.0083822091606829,100.2300033569336,100.31999969482422,99.83000183105469,100.04000091552734,0.0,99.89949989318848,100.91410452573159,98.88489526064537,0.0,0.0,2.031250674183387,51.15341192081733,-0.33870925203581814,-0.07990594172992935,0.14419271892825236,0.0,99.89949989318848,100.69000244140625,98.88999938964844,1.0079129780335534,0.9898948392672697,0.0,0.0,7679.4189453125,7795.60107421875,7679.4189453125,7795.60107421875,36162144724,7161.3514404296875,7789.563415307561,6533.139465551814,1.0,0.0,17.544509024687105,70.40100842045175,1.5069777105927384,17.3663374241098,193.58623495945358,-129888773211,7161.3514404296875,7795.60107421875,6642.10986328125,1.0885656344427368,0.9274939120824264,2.0,0.0,54
2020-04-28,1713.0,1731.9000244140625,1704.0999755859375,1721.0,96211082,1719.4599975585938,1777.817628017845,1661.1023670993427,0.0,0.0,6.787902078805122,53.5477254813188,0.04068773772063494,-1.7301460619726556,15.119768447822253,-57609568,1719.4599975585938,1769.4000244140625,1648.800048828125,1.0290440178465199,0.9589057327121325,0.0,0.0,1.0196705475834809,100.05999755859375,100.20999908447266,99.44999694824219,99.87000274658203,0.0,99.93400001525879,100.89384355021018,98.9741564803074,0.0,0.0,1.9209548998435608,48.6084665778726,-0.1699301953114296,0.35169424771077906,0.11098907547474823,0.0,99.93400001525879,100.69000244140625,98.88999938964844,1.0075650171716535,0.9895530987906924,0.0,0.0,7796.97021484375,7814.52734375,7730.806640625,7807.05859375,33187959920,7184.999438476562,7870.442799526935,6499.556077426189,0.0,0.0,19.079844526632495,70.64266328869088,0.1469741643032707,9.69893754568972,209.6951181479717,-96700813291,7184.999438476562,7807.05859375,6642.10986328125,1.0865774814041367,0.9244412501568099,2.0,0.0,55
2020-04-29,1724.800048828125,1733.5,1708.199951171875,1722.199951171875,156725,1723.1299926757813,1771.6549694858725,1674.6050158656901,0.0,0.0,5.632189912119007,53.86439538603599,0.06972406576843948,-1.210353758117189,13.693785590186735,-57452843,1723.1299926757813,1769.4000244140625,1680.699951171875,1.0268523163864325,0.9753761807383908,0.0,0.0,0.9854657674703009,99.87999725341797,99.88999938964844,99.47000122070312,99.56999969482422,0.0,99.96500015258789,100.83120013931496,99.09880016586082,0.0,0.0,1.7330065230928604,44.28801639422562,-0.3003935551289194,0.07035145208464197,0.05851357604790053,0.0,99.96500015258789,100.69000244140625,98.88999938964844,1.0072525612735628,0.9892462285670128,0.0,0.0,7806.71240234375,8871.75390625,7786.04931640625,8801.0380859375,60201052202,7259.946875,8243.277084302816,6276.616665697183,1.0,0.0,27.089184707093782,83.57152338217945,12.731805202323422,24.024931971998047,304.0476220284663,-36499761089,7259.946875,8801.0380859375,6642.10986328125,1.2122730699647855,0.9148978605000123,3.0,0.0,56
2020-04-30,1729.5999755859375,1737.0,1687.5,1713.4000244140625,228730,1722.2649963378906,1770.8361204952532,1673.693872180528,0.0,0.0,5.64037755637385,51.02976554773307,-0.5109700968127795,-0.9652593149259588,11.639167641387303,-57681573,1722.2649963378906,1769.4000244140625,1680.699951171875,1.0273680462509525,0.9758660570502236,0.0,0.0,0.9814974350339359,99.4800033569336,99.7300033569336,98.80999755859375,99.0199966430664,0.0,99.93250007629395,100.88501175060587,98.97998840198203,0.0,0.0,1.906310106491325,37.49864490737108,-0.5523782800477384,0.13145642048772885,-0.028964457464411453,0.0,99.93250007629395,100.69000244140625,98.88999938964844,1.0075801402400018,0.9895679515087723,0.0,0.0,8797.669921875,9440.650390625,8533.255859375,8658.5537109375,66964629541,7349.59990234375,8487.531846517773,6211.667958169726,1.0,0.0,30.96582016147962,78.093713385292,-1.6189496467202469,19.302195187227298,356.29177863214954,-103464390630,7349.59990234375,8801.0380859375,6642.10986328125,1.1974853329268842,0.9037376117798079,4.0,0.0,57
2020-05-01,1693.5,1714.4000244140625,1676.0,1694.199951171875,164380,1722.2799926757812,1770.8162495147208,1673.7437358368416,0.0,0.0,5.636279472019222,45.256083658861776,-1.1205832245014369,-0.017707219128061377,8.254328660201054,-57845953,1722.2799926757812,1769.4000244140625,1680.699951171875,1.027359100691331,0.9758575599317587,0.0,0.0,0.9728953298607715,99.12999725341797,99.20999908447266,98.77999877929688,98.80000305175781,0.0,99.86350021362304,100.92768684902278,98.7993135782233,0.0,0.0,2.131282466813762,35.10677941001573,-0.22217087332531138,-0.6635793673739134,-0.11226643896621624,0.0,99.86350021362304,100.69000244140625,98.80000305175781,1.0082763194361823,0.9893504918254392,0.0,0.0,8672.7822265625,9048.0234375,8667.763671875,8864.7666015625,44068389996,7449.88408203125,8740.49870433702,6159.2694597254795,1.0,0.0,34.647911513648076,80.1825413152842,2.3816089558295506,23.302862779546402,406.65039974557476,-59396000634,7449.88408203125,8864.7666015625,6642.10986328125,1.1899200717691536,0.8915722432919042,5.0,0.0,58
2020-05-04,1711.199951171875,1726.0,1700.300048828125,1700.9000244140625,146307,1721.5799987792968,1767.2172557524007,1675.942741806193,0.0,0.0,5.301787544634972,47.54396222533959,-0.3223159822614563,-0.3981921269685688,4.891747762488876,-57517912,1721.5799987792968,1769.4000244140625,1687.800048828125,1.0277768245847843,0.9803785185846003,0.0,0.0,0.9883207579396064,99.08999633789062,99.5999984741211,99.08999633789062,99.4800033569336,0.0,99.80850028991699,100.83179510706131,98.78520547277267,0.0,0.0,2.0505163671870044,46.76814364812131,0.6882593969349982,-0.5498304799310998,-0.11311304925813204,0.0,99.80850028991699,100.69000244140625,98.80000305175781,1.0088319346441308,0.989895677870825,0.0,0.0,8895.7451171875,8956.90625,8645.0244140625,8912.654296875,45718796275,7756.8922119140625,9311.37609246921,6202.408331358915,0.0,0.0,40.08006913303669,77.76576443928181,0.17067266322232655,25.2268431462288,466.46354131021053,-20644600850,7756.8922119140625,8988.5966796875,6642.10986328125,1.1587883954197047,0.8562849246608607,6.0,0.0,60
2020-05-05,1703.9000244140625,1717.800048828125,1695.4000244140625,1712.0999755859375,90856691,1720.275,1765.4267080653242,1675.123291934676,0.0,0.0,5.249359325145584,51.46743810115274,0.6584720448653769,0.35756011640899765,4.466273697257066,33338779,1720.275,1769.4000244140625,1687.800048828125,1.028556494987175,0.9811222326826379,0.0,0.0,0.994135422208632,99.51000213623047,99.97000122070312,99.30000305175781,99.70999908447266,0.0,99.7595001220703,100.69974450832166,98.81925573581896,0.0,0.0,1.8850222487097963,50.13564943622097,0.23119794911328206,-0.0701540345566158,-0.09186804324990305,0.0,99.7595001220703,100.43000030517578,98.80000305175781,1.0067211662276276,0.9903818977727594,0.0,0.0,8912.83203125,9062.4150390625,8856.8271484375,9003.0703125,43148462663,7874.940234375,9431.450056762695,6318.430411987305,0.0,0.0,39.53070819746299,78.95737584354715,1.0144678859214995,21.176366364100705,469.30583629103876,22503861813,7874.940234375,9003.0703125,6880.3232421875,1.1432557003036778,0.8736984710251026,6.0,0.0,61
2020-05-06,1710.699951171875,1715.199951171875,1683.300048828125,1691.9000244140625,98111911,1716.4,1757.106123426093,1675.6938765739071,0.0,0.0,4.7431977891042845,44.758648813585516,-1.1798347911874618,0.242918323695049,2.3250607821867106,-64773132,1716.4,1751.300048828125,1687.800048828125,1.0203332840993504,0.9833372458798211,0.0,0.0,0.9874518503013606,99.80000305175781,100.19999694824219,99.75,100.08999633789062,0.0,99.76499977111817,100.71160408958278,98.81839545265356,0.0,0.0,1.8976681614520465,55.323998807665475,0.38110245402374066,0.13004927431833274,-0.041650236891612735,0.0,99.76499977111817,100.43000030517578,98.80000305175781,1.0066656696795797,0.9903273019438253,0.0,0.0,9007.44140625,9411.4677734375,8966.7060546875,9268.76171875,49371886931,7982.538110351563,9610.422391260769,6354.653829442357,0.0,0.0,40.78613239060405,82.09116280868272,2.9511199738283755,22.75040908883686,486.28694980427645,71875748744,7982.538110351563,9268.76171875,6880.3232421875,1.161129654580727,0.8619217530906946,6.0,0.0,62
2020-05-07,1695.300048828125,1733.199951171875,1686.800048828125,1723.199951171875,104619464,1714.9949951171875,1752.6079917412837,1677.3819984930913,0.0,0.0,4.386368092173482,54.883668417398454,1.8499867785422008,-1.3962019200579143,3.4096966417125714,39846332,1714.9949951171875,1747.5999755859375,1687.800048828125,1.019011705900939,0.98414284218526,0.0,0.0,1.017117223961635,100.20999908447266,100.4000015258789,99.80999755859375,99.88999938964844,0.0,99.75349960327148,100.68808522198319,98.81891398455977,0.0,0.0,1.8737901375463273,52.15077837364972,-0.1998171201515686,-0.36904322631001135,-0.021070553471744802,0.0,99.75349960327148,100.43000030517578,98.80000305175781,1.0067817239955972,0.9904414726770909,0.0,0.0,9261.8955078125,9992.6640625,9138.322265625,9951.5185546875,61112700562,8125.3048095703125,9910.446313444872,6340.163305695753,1.0,0.0,43.94029628948684,87.43435156404546,7.366214135771076,31.461065304524627,549.5499772081566,132988449306,8125.3048095703125,9951.5185546875,6880.3232421875,1.2247563368904264,0.8467772475542797,7.0,0.0,63
2020-05-08,1727.0,1735.5,1703.0999755859375,1704.800048828125,106158530,1713.0699951171875,1748.5730539698532,1677.566936264522,0.0,0.0,4.144963014221369,49.01559491066125,-1.067775235905566,-2.3428941678261612,2.560501397284497,-66312198,1713.0699951171875,1747.5999755859375,1687.800048828125,1.0201567831829241,0.9852487368519148,0.0,0.0,0.9990623678134986,99.83999633789062,99.94000244140625,99.45999908447266,99.7300033569336,0.0,99.76399993896484,100.69255523550757,98.83544464242212,0.0,0.0,1.8615037430552335,49.62092766235367,-0.16017222313791102,-0.6574320517257601,-0.01932385466487574,0.0,99.76399993896484,100.43000030517578,98.80000305175781,1.0066757584561403,0.9903372269776993,0.0,0.0,9936.162109375,9996.7431640625,9767.1728515625,9842.666015625,51780748041,8254.554858398438,10141.142793403375,6367.966923393502,0.0,0.0,45.71022828894192,83.04522800264073,-1.0938284289408906,28.1619300870885,577.4405702643508,81207701265,8254.554858398438,9951.5185546875,6880.3232421875,1.2055790682113547,0.8335183859354024,7.0,0.0,64
2020-05-11,1709.300048828125,1712.5999755859375,1692.0999755859375,1700.0999755859375,99062967,1712.2749938964844,1746.4598821616028,1678.090105631366,0.0,0.0,3.9929203412971215,47.41450525525731,-0.4974833267854306,-1.1742180241143323,1.187601068042568,-165025127,1712.2749938964844,1747.5999755859375,1687.800048828125,1.020630437175904,0.9857061832032811,0.0,0.0,0.9929910635061523,99.66999816894531,100.27999877929688,99.66999816894531,100.23999786376953,0.0,99.80099983215332,100.74339814586293,98.85860151844372,0.0,0.0,1.8885548547500353,57.00746543475492,0.5113752027167573,-0.18918892843661378,0.026459136899433133,0.0,99.80099983215332,100.43000030517578,98.80000305175781,1.006302546808953,0.9899700726237313,0.0,0.0,8755.53515625,9033.470703125,8374.3232421875,8601.7958984375,57119858801,8554.57568359375,10182.769565578405,6926.381801609095,0.0,0.0,38.0660348848689,48.78996619206258,-1.7659566044374797,-2.263848713691556,387.6301387147614,-85803558713,8554.57568359375,9951.5185546875,7117.20751953125,1.1632977394510464,0.8319766850833838,7.0,0.0,66
2020-05-12,1704.199951171875,1716.5999755859375,1700.4000244140625,1706.0999755859375,90418137,1713.0699951171875,1745.8761400583933,1680.2638501759818,0.0,0.0,3.8300997664676895,49.63355673310126,0.3529204215141579,-0.8657771303929402,0.9248374821670495,-74606990,1713.0699951171875,1747.5999755859375,1687.800048828125,1.0201567831829241,0.9852487368519148,0.0,0.0,1.0083929020432474,100.2300033569336,100.44000244140625,99.66000366210938,99.93000030517578,0.0,99.85299987792969,100.69836513969463,99.00763461616475,0.0,0.0,1.6932195583475684,51.870986298176014,-0.3092553523545094,-0.4482934454621785,0.03305266000774054,0.0,99.85299987792969,100.43000030517578,98.80000305175781,1.0057784986725633,0.9894545298843384,0.0,0.0,8610.3857421875,8949.8984375,8569.6435546875,8804.4775390625,42142717533,8638.939184570312,10129.52002967917,7148.358339461454,0.0,0.0,34.508423158508364,52.74512543071419,2.3562712138033515,1.6853141182304934,332.92447612824253,-43660841180,8638.939184570312,9951.5185546875,7429.724609375,1.1519375634061109,0.8600274235805427,7.0,0.0,67
2020-05-13,1705.5999755859375,1727.0,1701.5999755859375,1725.800048828125,94675242,1713.975,1747.135373786396,1680.8146262136038,0.0,0.0,3.8694116059331227,56.352954426317176,1.1546845744149214,0.20904063165257353,2.419943723424012,20068252,1713.975,1747.5999755859375,1687.800048828125,1.019618124876931,0.9847285105256057,0.0,0.0,1.0015088775127239,100.01000213623047,100.27999877929688,99.58000183105469,100.23999786376953,0.0,99.89199981689453,100.73320253224863,99.05079710154043,0.0,0.0,1.684224396139939,56.250852843326825,0.3102147079426132,0.19991697962004487,0.06420085474094606,0.0,99.89199981689453,100.43000030517578,98.80000305175781,1.0053858215799807,0.9890682260127099,0.0,0.0,8805.3876953125,9317.87890625,8805.3876953125,9269.9873046875,45558144023,8730.952319335938,10136.35971797008,7325.544920701798,0.0,0.0,32.19367938871148,60.52545388529024,5.287193516704303,4.571137869028339,326.96702636933696,1897302843,8730.952319335938,9951.5185546875,7550.90087890625,1.13979760634455,0.86484275743709,7.0,0.0,68
2020-05-14,1721.9000244140625,1746.5,1716.0,1742.800048828125,105081916,1715.8150024414062,1751.0218841082728,1680.6081207745397,0.0,0.0,4.103808582716817,61.30295688954308,0.9850503835333368,1.715887941820039,4.956668365680571,125150168,1715.8150024414062,1747.5999755859375,1687.800048828125,1.0185247087240203,0.9836725092312287,0.0,0.0,1.0222900040542122,100.19000244140625,100.55999755859375,100.1500015258789,100.47000122070312,0.0,99.91399993896485,100.79075210957566,99.03724776835404,0.0,0.0,1.7550136540352739,59.30394307458195,0.2294526754142323,0.6007794709324049,0.10606061672832823,0.0,99.91399993896485,100.47000122070312,98.80000305175781,1.0055647985475302,0.988850442501676,0.0,0.0,9271.3291015625,9793.2685546875,9255.03515625,9733.7216796875,56426907637,8840.093359375,10200.287421725036,7479.899297024965,0.0,0.0,30.773296322884132,66.61044480591457,5.002535168149658,8.289669973554819,357.04536180548166,58324210480,8840.093359375,9951.5185546875,7569.93603515625,1.125725504259955,0.8563185621934936,6.0,0.0,69
2020-05-15,1742.5,1761.199951171875,1736.800048828125,1754.0999755859375,100958337,1719.1299987792968,1755.6231217255242,1682.6368758330693,0.0,0.0,4.245533842366795,64.29370317272429,0.6483776934371077,3.5355935627686548,7.727022372258034,226108505,1719.1299987792968,1754.0999755859375,1691.9000244140625,1.0203416709797815,0.9841606077582443,0.0,0.0,1.026629989845573,100.26000213623047,100.48999786376953,100.08000183105469,100.4000015258789,0.0,99.94500007629395,100.84416556770874,99.04583458487916,0.0,0.0,1.7993206077910953,57.93670758646555,-0.06967223447170712,0.8335862544929104,0.1291505861501605,0.0,99.94500007629395,100.47000122070312,98.80000305175781,1.0052529005353785,0.9885437288142269,0.0,0.0,9734.291015625,9755.828125,9261.3984375,9328.197265625,48158802327,8928.006420898437,10170.665755033337,7685.347086763537,0.0,0.0,27.837330654828303,57.93331011247502,-4.166180495059313,4.841023078895332,338.0182000353889,10165408153,8928.006420898437,9951.5185546875,7679.8671875,1.1146406135409193,0.8601995591673381,6.0,0.0,70
2020-05-18,1771.0,1775.800048828125,1729.300048828125,1736.5,142944830,1719.6850036621095,1759.2231116005323,1680.1468957236866,0.0,0.0,4.598296531542175,54.58426086347909,-1.7761199151784313,2.093008117758198,10.236042828583095,83878157,1719.6850036621095,1767.9000244140625,1691.9000244140625,1.0280371234553294,0.9838429833435319,1.0,0.0,1.0178184308358729,100.36000061035156,100.47000122070312,99.58000183105469,99.66999816894531,0.0,99.93050003051758,100.83754897704745,99.02345108398771,0.0,0.0,1.8153595674050813,45.72226417112471,-0.7270949659751058,0.6564346070642093,0.08080303328375749,0.0,99.93050003051758,100.47000122070312,98.80000305175781,1.0053987640412165,0.988687167797474,0.0,0.0,9675.6953125,9906.0302734375,9570.359375,9726.5751953125,41827139895,9202.596484375,10040.125142268553,8365.067826481449,0.0,0.0,18.2020076467676,63.689083037932775,0.5773698991511145,4.939316496144012,335.72068906025925,128241565117,9202.596484375,9951.5185546875,8601.7958984375,1.0813816048094782,0.9347140139244838,5.0,0.0,72
2020-05-19,1740.199951171875,1751.5999755859375,1727.199951171875,1749.0,98019332,1720.0650024414062,1760.5649994768119,1679.5650054060006,0.0,0.0,4.709124013094993,58.165393450031516,0.7198387561186292,2.155249397829942,10.694840607406377,181897489,1720.0650024414062,1767.9000244140625,1691.9000244140625,1.0278100082873385,0.9836256315968482,1.0,0.0,1.0134430122351825,99.62000274658203,99.7300033569336,99.2300033569336,99.37000274658203,0.0,99.88600006103516,100.81116702747484,98.96083309459549,0.0,0.0,1.8524457198693594,41.70732080100906,-0.3009886905533721,0.5769227502205807,0.017640469991306418,0.0,99.88600006103516,100.47000122070312,98.80000305175781,1.0058466768046683,0.9891276354182392,0.0,0.0,9727.0634765625,9836.0478515625,9539.6240234375,9729.0380859375,39254288954,9248.996484375,10095.176568809145,8402.816399940855,0.0,0.0,18.29777070114922,63.72683820332082,0.025321252090737545,-2.235643409871393,333.9663093386789,167495854071,9248.996484375,9951.5185546875,8601.7958984375,1.0759565723156368,0.9300247776036176,4.0,0.0,73
2020-05-20,1754.9000244140625,1757.5999755859375,1744.0,1749.699951171875,90999071,1721.5349975585937,1764.0466571966315,1679.0233379205558,0.0,0.0,4.9388086444162935,58.3696328273028,0.040020078437685846,3.4162731794882344,10.909879919902323,272896560,1721.5349975585937,1767.9000244140625,1691.9000244140625,1.0269323754214823,0.9827857271640958,1.0,0.0,1.003959090056481,99.55000305175781,99.55999755859375,99.0,99.12000274658203,0.0,99.82250022888184,100.77452560331182,98.87047485445186,0.0,0.0,1.9074364441826073,38.57116704727495,-0.25158497845427785,-0.36188238661380284,-0.05106671703455845,0.0,99.82250022888184,100.47000122070312,98.80000305175781,1.006486523482548,0.9897568466550172,0.0,0.0,9725.3291015625,9804.7939453125,9447.201171875,9522.9814453125,36546239702,9292.21787109375,10100.819998370498,8483.615743817001,0.0,0.0,17.40385639885069,58.11003417237303,-2.117954918100662,-3.247946946538756,309.04424448047394,130949614369,9292.21787109375,9951.5185546875,8601.7958984375,1.0709519183406906,0.9256989039393905,3.0,0.0,74
2020-05-21,1742.0999755859375,1744.800048828125,1715.300048828125,1725.300048828125,117665805,1721.75,1764.2921459110378,1679.2078540889622,0.0,0.0,4.941733226198668,49.08741448035712,-1.3945192332781353,0.12187196586338184,8.767603538440426,155230755,1721.75,1767.9000244140625,1691.9000244140625,1.0268041378911354,0.9826630024185059,1.0,0.0,0.9835813652821059,99.18000030517578,99.51000213623047,99.0199966430664,99.37000274658203,0.0,99.76950035095214,100.69807769887443,98.84092300302986,0.0,0.0,1.8614453207761776,43.30776097556251,0.25221952489162813,-0.3409851980868897,-0.0793985876548362,0.0,99.76950035095214,100.47000122070312,98.80000305175781,1.0070211925216312,0.9902826285008545,0.0,0.0,9522.740234375,9555.2421875,8869.9306640625,9081.76171875,39326160532,9303.067626953125,10094.068241538691,8512.067012367559,0.0,0.0,17.005156713982288,48.036841502160364,-4.633209978369557,-5.338131034237058,247.04318560634238,91623453837,9303.067626953125,9951.5185546875,8601.7958984375,1.0697029145371,0.9246193022950968,2.0,0.0,75
2020-05-22,1728.199951171875,1742.0,1726.0,1734.699951171875,101050564,1722.375,1765.290864602445,1679.459135397555,0.0,0.0,4.9833357546927965,52.33217674918101,0.5448271070376931,1.7538656433229876,7.8437869648093965,256281319,1722.375,1767.9000244140625,1691.9000244140625,1.0264315404102258,0.9823064224771392,1.0,0.0,0.981220616107412,99.41999816894531,99.87000274658203,99.38999938964844,99.86000061035156,0.0,99.74350051879883,100.63043269872725,98.8565683388704,0.0,0.0,1.778426013354646,51.45884972069267,0.493104407996392,-0.22978892592085554,-0.05657260605335068,0.0,99.74350051879883,100.47000122070312,98.80000305175781,1.0072836896451953,0.9905407624343083,0.0,0.0,9080.3349609375,9232.9365234375,9008.638671875,9182.5771484375,29810773699,9312.766650390626,10092.786447447043,8532.746853334209,0.0,0.0,16.751623364764512,50.227308484077525,1.110086707949609,4.866668859995194,205.5971024195369,121434227536,9312.766650390626,9951.5185546875,8601.7958984375,1.0685888445696297,0.9236563334352091,1.0,0.0,76
2020-05-26,1734.800048828125,1737.199951171875,1700.0,1735.5,300259,1725.275,1766.2584466155422,1684.291553384458,0.0,0.0,4.750946558147786,52.64807522366077,0.31212210220590286,2.082231922970408,6.0770327952334355,256487657,1725.275,1767.9000244140625,1691.9000244140625,1.0247062204077972,0.9806552720082667,1.0,0.0,0.9922813036020584,99.7699966430664,99.7699966430664,98.9000015258789,99.01000213623047,0.0,99.69200057983399,100.62262466899841,98.76137649066956,0.0,0.0,1.8669985229540567,40.29277276559225,-0.8511901351149986,-0.8809663217488841,-0.11228878009818288,0.0,99.69200057983399,100.47000122070312,98.80000305175781,1.007804042815312,0.9910524663675311,0.0,0.0,8909.5859375,8991.9677734375,8757.2939453125,8835.052734375,29584186947,9295.751025390626,10105.994414577215,8485.507636204036,0.0,0.0,17.43255358224359,43.35557294806799,-0.8070322664891605,-9.23253175800021,36.45841940996797,118347261365,9295.751025390626,9951.5185546875,8601.7958984375,1.0705448680268754,0.9253470617857943,1.0,0.0,78
2020-05-27,1724.0999755859375,1729.0999755859375,1701.5999755859375,1728.199951171875,156746,1726.3649963378907,1766.4317987511126,1686.2981939246688,0.0,0.0,4.641753337007523,49.53371800874652,-0.4206308745678511,1.2953505598842503,4.933509002130677,256330911,1726.3649963378907,1767.9000244140625,1691.9000244140625,1.0240592390162446,0.980036103606747,1.0,0.0,0.9877121788878144,99.0199966430664,99.33999633789062,98.72000122070312,99.05999755859375,0.0,99.65150032043456,100.61744479129476,98.68555584957437,0.0,0.0,1.9386451137296465,41.12764788041444,0.05049532500209786,-0.671819688947461,-0.14726021816747448,0.0,99.65150032043456,100.47000122070312,98.80000305175781,1.0082136334890757,0.99145524888297,0.0,0.0,8837.380859375,9203.3203125,8834.1572265625,9181.017578125,32740536902,9257.2259765625,10010.342285282473,8504.109667842527,0.0,0.0,16.270885265774375,52.103441194401164,3.9158209254817056,-1.5777934718679942,39.20514297313093,151087798267,9257.2259765625,9842.666015625,8601.7958984375,1.063241411686905,0.9291980038313398,0.0,0.0,79
2020-05-28,1725.0,1743.699951171875,1720.0,1726.800048828125,159174,1727.6599975585937,1765.9873433849257,1689.3326517322616,0.0,0.0,4.436908405646192,48.9171562369624,-0.08100349399967621,0.05794414020784348,3.8803719826321412,256171737,1727.6599975585937,1767.9000244140625,1691.9000244140625,1.0232916354562431,0.9793014984458374,1.0,0.0,1.0008694139903485,98.91000366210938,99.08999633789062,98.3499984741211,98.37999725341797,0.0,99.59200019836426,100.70595854685465,98.47804184987388,0.0,1.0,2.237043831375286,33.95288364559583,-0.6864529799463837,-1.8555473363830108,-0.22947269063801912,0.0,99.59200019836426,100.47000122070312,98.37999725341797,1.0088159794018605,0.9878303182732322,0.0,1.0,9184.9453125,9546.3193359375,9148.45703125,9525.7509765625,34367073114,9241.380224609375,9956.958976598042,8525.801472620708,0.0,0.0,15.486404294525476,59.097149328645976,3.7548495632866885,1.5861905494882245,70.40660239373028,185454871381,9241.380224609375,9733.7216796875,8601.7958984375,1.0532757491967533,0.9307912551343044,0.0,0.0,80
2020-05-29,1732.699951171875,1754.5,1725.300048828125,1728.300048828125,147014,1728.4700012207031,1766.1266087514985,1690.8133936899078,0.0,0.0,4.357218523225856,49.66311193986696,0.08686587662642964,-0.8319944683126407,3.163454587546312,256318751,1728.4700012207031,1767.9000244140625,1691.9000244140625,1.0228120957641802,0.9788425736166588,1.0,0.0,0.9963106574486115,98.5199966430664,98.55000305175781,97.94999694824219,98.33999633789062,0.0,99.55800018310546,100.7763368844711,98.33966348173982,0.0,0.0,2.447491309839287,33.57010754935283,-0.04065960219973297,-1.5911177448508458,-0.2898210038001565,0.0,99.55800018310546,100.47000122070312,98.33999633789062,1.0091604997681787,0.9877658867898641,0.0,1.0,9528.35546875,9573.6669921875,9379.3388671875,9439.1240234375,32896642044,9233.6416015625,9937.047874257149,8530.235328867851,0.0,0.0,15.235728286781663,56.78219443210144,-0.9093976247976698,-2.3950106418998915,84.78445559220381,152558229337,9233.6416015625,9733.7216796875,8601.7958984375,1.0541584891101228,0.9315713420133093,0.0,0.0,81
2020-06-01,1749.800048828125,1761.0,1737.5999755859375,1751.699951171875,142807,1733.054998779297,1769.2580535666136,1696.8519439919803,0.0,0.0,4.177946437108669,59.1035014746224,-0.19372254921987686,-0.916345552263721,5.803361792850183,256620249,1733.054998779297,1767.9000244140625,1700.0999755859375,1.0201061279990014,0.9809844331446077,1.0,0.0,1.0093344576040766,98.30000305175781,98.31999969482422,97.79000091552734,97.81999969482422,0.0,99.50900001525879,100.91041268157997,98.10758734893761,0.0,1.0,2.8166551087967613,28.869113598496526,-0.5287743160775848,-2.4142041306048254,-0.3744972392843948,0.0,99.50900001525879,100.47000122070312,97.81999969482422,1.0096574300344388,0.9830266576874898,0.0,2.0,9463.60546875,10199.5654296875,9450.8994140625,10167.2685546875,35198901068,9391.94345703125,10070.592941771643,8713.293972290856,1.0,0.0,14.451737020037633,66.77543516773946,7.464386293982206,6.765602905717491,177.0793601936548,192706815248,9391.94345703125,10167.2685546875,8790.3681640625,1.082552147082594,0.9359477305500192,1.0,0.0,83
2020-06-02,1750.300048828125,1757.0,1728.0,1750.300048828125,172030,1735.3299987792968,1769.8230210710897,1700.836976487504,0.0,0.0,3.9753847759281133,58.28471113688799,-0.07991678842106387,0.7947047986251079,6.251639643112412,256448219,1735.3299987792968,1767.9000244140625,1700.0999755859375,1.018768779227972,0.9796983725181138,1.0,0.0,1.0127879286429005,97.83999633789062,97.91000366210938,97.43000030517578,97.66999816894531,0.0,99.41849975585937,101.03324855069715,97.80375096102159,0.0,1.0,3.2483869678240898,27.629018353821678,-0.15334443503054462,-2.786904566276482,-0.4436819917876278,0.0,99.41849975585937,100.47000122070312,97.66999816894531,1.0105765171213197,0.9824127140199477,0.0,3.0,10162.9736328125,10182.3408203125,9460.5712890625,9529.8037109375,39137252108,9404.93427734375,10083.69528594056,8726.17326874694,0.0,0.0,14.43414676978505,53.08100843630623,-6.269774820259899,4.9334259812441745,163.0153511907538,153569563140,9404.93427734375,10167.2685546875,8790.3681640625,1.0810568425959335,0.9346549273861782,1.0,0.0,84
2020-06-03,1733.699951171875,1738.9000244140625,1690.300048828125,1734.0,249036,1736.6,1768.8609969744714,1704.3390030255284,0.0,0.0,3.7154205890212464,49.426119732560565,-0.9312716890477302,-0.8576329331046313,5.063968548999355,256199183,1736.6,1767.9000244140625,1700.0999755859375,1.0180237385777167,0.9789819046331554,1.0,0.0,1.0041695338014156,97.56999969482422,97.62999725341797,97.19000244140625,97.27999877929688,0.0,99.29699974060058,101.15334226536099,97.44065721584018,0.0,1.0,3.73897001844938,24.578943205178476,-0.39930316060192705,-3.107572409526135,-0.5209800545749346,0.0,99.29699974060058,100.47000122070312,97.27999877929688,1.011813060648024,0.9796871912890335,0.0,4.0,9533.7607421875,9682.859375,9471.8466796875,9656.7177734375,25007459262,9401.08408203125,10073.18226337727,8728.98590068523,0.0,0.0,14.298312311250024,55.11719747360992,1.3317594606312655,5.1634809850813985,160.7697854147391,178577022402,9401.08408203125,10167.2685546875,8790.3681640625,1.0814995872785242,0.9350377134551917,1.0,0.0,85
2020-06-04,1702.800048828125,1729.0,1698.9000244140625,1704.800048828125,193873,1736.8350036621093,1768.0815721355168,1705.5884351887019,0.0,1.0,3.598104414929941,37.94639943666347,-1.6839648888047898,-2.5661486881609585,1.5689613856798132,256005310,1736.8350036621093,1767.9000244140625,1704.800048828125,1.017885994171267,0.9815555566496307,1.0,1.0,0.9864028239680175,97.31999969482422,97.62999725341797,96.56999969482422,96.68000030517578,0.0,99.12649993896484,101.26511989775663,96.98787998017305,0.0,1.0,4.314930841114344,20.677034934123128,-0.6167747549856939,-2.999897580715658,-0.6211273186474529,0.0,99.12649993896484,100.47000122070312,96.68000030517578,1.0135534017902934,0.9753194187700015,0.0,5.0,9655.8544921875,9887.6103515625,9525.2470703125,9800.63671875,25921805071,9424.7060546875,10117.778878639321,8731.633230735679,0.0,0.0,14.707574324975631,57.44418497397698,1.4903505382374727,6.421231115414021,168.78410583418736,204498827473,9424.7060546875,10167.2685546875,8790.3681640625,1.0787889294044006,0.9326941459028842,1.0,0.0,86
