Date,Open,High,Low,Close,Volume,boll_mavg,boll_hband,boll_lband,boll_hband_ind,boll_lband_ind,boll_bandwidth,RSI,daily_return,ROC,MACD,on_balance_volume,avg_close,max_close,min_close,max_close_pct,min_close_pct,boll_hband_num,boll_lband_num,pct_change,DX-Y.NYB_Open,DX-Y.NYB_High,DX-Y.NYB_Low,DX-Y.NYB_Close,DX-Y.NYB_Volume,DX-Y.NYB_boll_mavg,DX-Y.NYB_boll_hband,DX-Y.NYB_boll_lband,DX-Y.NYB_boll_hband_ind,DX-Y.NYB_boll_lband_ind,DX-Y.NYB_boll_bandwidth,DX-Y.NYB_RSI,DX-Y.NYB_daily_return,DX-Y.NYB_ROC,DX-Y.NYB_MACD,DX-Y.NYB_on_balance_volume,DX-Y.NYB_avg_close,DX-Y.NYB_max_close,DX-Y.NYB_min_close,DX-Y.NYB_max_close_pct,DX-Y.NYB_min_close_pct,DX-Y.NYB_boll_hband_num,DX-Y.NYB_boll_lband_num,BTC-USD_Open,BTC-USD_High,BTC-USD_Low,BTC-USD_Close,BTC-USD_Volume,BTC-USD_boll_mavg,BTC-USD_boll_hband,BTC-USD_boll_lband,BTC-USD_boll_hband_ind,BTC-USD_boll_lband_ind,BTC-USD_boll_bandwidth,BTC-USD_RSI,BTC-USD_daily_return,BTC-USD_ROC,BTC-USD_MACD,BTC-USD_on_balance_volume,BTC-USD_avg_close,BTC-USD_max_close,BTC-USD_min_close,BTC-USD_max_close_pct,BTC-USD_min_close_pct,BTC-USD_boll_hband_num,BTC-USD_boll_lband_num,day
2020-03-16,1569.0999755859375,1569.0999755859375,1452.0999755859375,1485.9000244140625,193,1623.8900024414063,1725.1601787760364,1522.6198261067761,0.0,1.0,12.472541389179986,23.11801525076835,-1.9660835071461547,-9.396339974752287,-16.88023234628122,1560859,1623.8900024414063,1674.5,1485.9000244140625,1.0311659025442026,0.9150250461423586,0.0,2.0,0.8916826708140099,98.47000122070312,98.47000122070312,97.44999694824219,98.08999633789062,0.0,97.93850021362304,100.61761406173153,95.25938636551456,0.0,0.0,5.4710126094739335,53.13463680815054,-0.6683581388449378,-0.3555527172238305,-0.3374029889445751,0.0,97.93850021362304,99.87000274658203,94.9000015258789,1.0197215857782793,0.9689754419240996,0.0,0.0,5385.2294921875,5385.2294921875,4575.35791015625,5014.47998046875,45368026429,7747.8988037109375,10749.271645742541,4746.525961679335,0.0,0.0,77.47578841876624,20.145077317266427,-7.006915676163484,-42.72599619959997,-968.433865929771,-359360501166,7747.8988037109375,9122.5458984375,4970.7880859375,1.1774219216787087,0.6415659537985562,0.0,4.0,20
2020-03-17,1469.300048828125,1537.699951171875,1469.300048828125,1524.9000244140625,122,1619.7600036621093,1729.7304440956368,1509.7895632285818,0.0,0.0,13.578609199498171,34.43146383030725,2.6246718728858642,-2.506230534092941,-21.014301916139402,1560981,1619.7600036621093,1674.5,1485.9000244140625,1.0337951278054336,0.9173581401285356,0.0,2.0,0.9126765500657038,98.13999938964844,99.83000183105469,97.9800033569336,99.58000183105469,0.0,97.94450035095215,100.63771789763152,95.25128280427279,0.0,0.0,5.4994768200952535,63.35305205139365,1.519018808025474,1.4776364192614033,-0.12130093998943892,0.0,97.94450035095215,99.87000274658203,94.9000015258789,1.0196591170380211,0.9689160819222694,0.0,0.0,5002.578125,5371.3486328125,4981.9091796875,5225.62939453125,38622642935,7568.154150390625,10717.959012248613,4418.349288532636,0.0,0.0,83.23839074275236,24.34529391975387,4.210793838741411,-42.4411721078543,-976.8396773806271,-320737858231,7568.154150390625,9122.5458984375,4970.7880859375,1.205385846688475,0.6568032293159537,0.0,4.0,21
2020-03-18,1537.5,1542.0,1477.300048828125,1477.300048828125,333,1612.7950073242187,1739.1137456965143,1486.476268951923,0.0,1.0,15.664574579985905,28.703449161393976,-3.1215145139910194,-7.222256890881579,-27.831913173715293,1560648,1612.7950073242187,1674.5,1477.300048828125,1.0382596625086011,0.9159874888744275,0.0,3.0,0.8822335316978949,99.37999725341797,101.73999786376953,99.1500015258789,101.16000366210938,0.0,98.02250061035156,100.98034477350916,95.06465644719395,1.0,0.0,6.03503102806019,70.84331297110793,1.5866657983550692,3.9030433729822582,0.1775678511464207,0.0,98.02250061035156,101.16000366210938,94.9000015258789,1.0320079882906648,0.96814507827254,1.0,0.0,5227.11376953125,5331.833984375,5069.3359375,5238.4384765625,37878801016,7390.8513671875,10644.333192842183,4137.369541532816,0.0,0.0,88.0407862103377,24.612566599763753,0.24512036855608432,-42.57701156143556,-965.038176982137,-282859057215,7390.8513671875,9122.5458984375,4970.7880859375,1.2343024430092113,0.6725596063270683,0.0,4.0,22
2020-03-19,1481.5,1491.5999755859375,1471.0,1478.5999755859375,262,1604.4950073242187,1742.6261543236928,1466.3638603247446,0.0,0.0,17.218021417197484,29.0615455989346,0.08799341466505517,-9.956762829964697,-32.28423065074708,1560910,1604.4950073242187,1674.5,1477.300048828125,1.0436305456584294,0.9207258620840373,0.0,3.0,0.8912060739822183,100.79000091552734,102.83999633789062,100.7699966430664,102.76000213623047,0.0,98.16700057983398,101.69849494365076,94.6355062160172,1.0,0.0,7.194870665208519,76.29487393531215,1.5816512615651313,5.774575936426687,0.5342616232765778,0.0,98.16700057983398,102.76000213623047,94.9000015258789,1.0467876325981993,0.9667199870154105,2.0,0.0,5245.41650390625,6329.73583984375,5236.96875,6191.19287109375,51000731797,7266.788256835937,10504.5207744379,4029.055739233974,0.0,0.0,89.11041310598797,41.64926378629305,18.187755736638024,-30.513751243589155,-857.101825611162,-231858325418,7266.788256835937,9122.5458984375,4970.7880859375,1.2553752188741476,0.6840419605265685,0.0,4.0,23
2020-03-20,1483.5,1484.0,1483.5,1484.0,14,1595.3400085449218,1739.7868524308205,1450.8931646590231,0.0,0.0,18.10859667684832,30.66883582411046,0.3652119912907814,-9.572846135095858,-34.55353315156185,1560924,1595.3400085449218,1674.5,1477.300048828125,1.0496195112208577,0.9260095283233957,0.0,3.0,0.9041062373139356,102.94000244140625,102.98999786376953,101.08999633789062,102.81999969482422,0.0,98.34500045776367,102.3991176598017,94.29088325572565,1.0,0.0,8.244683884625442,76.47811647140077,0.05838610095998398,5.629755047361189,0.7942509726835993,0.0,98.34500045776367,102.81999969482422,94.9000015258789,1.0455030679366606,0.9649702687899798,3.0,0.0,6191.65380859375,6844.26171875,5865.78173828125,6198.7783203125,54442976102,7146.751733398438,10355.829019660054,3937.6744471368224,0.0,0.0,89.80519838865675,41.765682627103224,0.1225199953657663,-23.54847711789559,-761.7025512767186,-177415349316,7146.751733398438,9122.5458984375,4970.7880859375,1.2764604450726496,0.6955310987938546,0.0,4.0,24
2020-03-23,1505.300048828125,1567.0,1490.199951171875,1567.0,51,1582.5050048828125,1726.1603258003936,1438.8496839652314,0.0,0.0,18.155433376113596,51.31010212046814,4.774005454639685,-6.212595510811054,-27.90642349720906,2976940,1582.5050048828125,1674.5,1477.300048828125,1.0581325144838958,0.9335199852575012,0.0,3.0,1.0338457811445214,101.94999694824219,102.9800033569336,101.6500015258789,102.48999786376953,0.0,98.50500030517578,102.93117947114924,94.07882113920233,0.0,0.0,8.986709613239572,73.02815219418613,-0.3209510134547289,5.856226179319455,0.9443857702453897,0.0,98.50500030517578,102.81999969482422,94.9000015258789,1.043804876669004,0.9634028854562883,3.0,0.0,5831.37451171875,6443.9345703125,5785.00439453125,6416.31494140625,46491915999,6757.338037109375,9723.275021016249,3791.4010532025013,0.0,0.0,87.78418269498411,47.27742262455352,10.052048673231173,-18.898166338519925,-543.8687327633479,-213517488936,6757.338037109375,9122.5458984375,4970.7880859375,1.3500206513776694,0.7356133522756073,0.0,4.0,26
2020-03-24,1592.699951171875,1685.5,1592.699951171875,1660.199951171875,442,1583.5150024414063,1729.0448512378878,1437.9851536449248,0.0,0.0,18.380608781364092,64.63333222387433,5.947667592334072,-0.8539891805389669,-14.376187380404417,2977382,1583.5150024414063,1674.5,1477.300048828125,1.057457616390319,0.9329245675288691,0.0,3.0,1.1173025936428964,102.12999725341797,102.20999908447266,101.05000305175781,101.73999786376953,0.0,98.6435001373291,103.28721953731491,93.99978073734329,0.0,0.0,9.41515536963092,65.5599134867291,-0.7317787253707464,6.034394059074972,0.9742364512067923,0.0,98.6435001373291,102.81999969482422,94.9000015258789,1.0423393285080182,0.962050225243036,3.0,0.0,6436.642578125,6789.02294921875,6411.06640625,6734.8037109375,48221910672,6656.31591796875,9477.261602822902,3835.3702331145987,0.0,0.0,84.75996991786397,51.893295714228294,4.963733427047878,35.487644906658765,-438.0251312640139,-165295578264,6656.31591796875,9122.5458984375,4970.7880859375,1.3705097550750487,0.7467776690885177,0.0,4.0,27
2020-03-25,1676.5,1676.5,1631.0999755859375,1632.300048828125,476,1583.1300048828125,1728.0997574472638,1438.1602523183612,0.0,0.0,18.314320632838022,59.24144503422518,-1.6805145864542737,-1.6153292238068824,-6.526935957806472,2976906,1583.1300048828125,1674.5,1477.300048828125,1.057714776951594,0.933151443199056,0.0,3.0,1.070430862807108,101.5999984741211,101.91000366210938,100.83999633789062,101.05000305175781,0.0,98.74600028991699,103.5057206142319,93.98627996560208,0.0,0.0,9.640330363438386,59.35510981727329,-0.6781942466085211,6.480507299256283,0.9197240027190787,0.0,98.74600028991699,102.81999969482422,94.9000015258789,1.0412573612394023,0.9610515995306516,3.0,0.0,6738.716796875,6892.51123046875,6536.92626953125,6681.06298828125,44590107887,6536.430932617188,9130.02259741939,3942.839267814985,0.0,0.0,79.35803778970639,51.055256086140034,-0.7979552925792555,20.082940218730627,-356.74139997259863,-209885686151,6536.430932617188,9122.5458984375,4970.7880859375,1.3956463385722384,0.7604743532335001,0.0,4.0,28
2020-03-26,1660.5,1660.5,1650.0999755859375,1650.0999755859375,3,1587.4300048828125,1734.965885775515,1439.8941239901098,0.0,0.0,18.588017164711967,61.517192270276595,1.0904812978834055,0.5300323530201395,0.937688597396118,2976909,1587.4300048828125,1674.5,1477.300048828125,1.0548496594176542,0.9306237404383587,0.0,3.0,1.1169700947988777,100.95999908447266,101.0199966430664,99.23999786376953,99.41999816894531,0.0,98.79500007629395,103.56128388456268,94.0287162680252,0.0,0.0,9.648836083988057,47.54410341494274,-1.6130676235384334,3.1220769551935117,0.7223187111237195,0.0,98.79500007629395,102.81999969482422,94.9000015258789,1.0407409242919377,0.9605749425840665,3.0,0.0,6675.1708984375,6735.4638671875,6590.962890625,6716.4404296875,35319797641,6416.125659179687,8726.473435810538,4105.777882548836,0.0,0.0,72.01691174253695,51.6266555462218,0.5295181540467819,29.153220316703205,-287.3300039602718,-174565888510,6416.125659179687,8909.9541015625,4970.7880859375,1.388681359258424,0.7747335931343065,0.0,4.0,29
2020-03-27,1623.9000244140625,1623.9000244140625,1623.9000244140625,1623.9000244140625,100638,1589.0100036621093,1737.395041875305,1440.6249654489136,0.0,0.0,18.676413348087216,56.36975405188645,-1.587779623023844,2.177057479577245,4.178818558922558,2876271,1589.0100036621093,1674.5,1477.300048828125,1.0538007917765566,0.9296983942350696,0.0,3.0,1.0982686671359816,99.29000091552734,99.80999755859375,98.2699966430664,98.37000274658203,0.0,98.80700035095215,103.56773181888468,94.04626888301962,0.0,0.0,9.636425457756857,41.61684411545003,-1.0561209431718344,1.9272620134502167,0.47277114335503256,0.0,98.80700035095215,102.81999969482422,94.9000015258789,1.0406145245743552,0.9604582791583998,3.0,0.0,6719.38916015625,6793.83642578125,6466.70166015625,6469.79833984375,34585598366,6294.11787109375,8302.824753366787,4285.410988820713,0.0,0.0,63.82806688442195,47.3450504325987,-3.672214358569481,19.981833593653295,-252.32642414609745,-209151486876,6294.11787109375,8108.1162109375,4970.7880859375,1.288205333455016,0.7897513500289294,0.0,4.0,30
2020-03-30,1641.199951171875,1652.800048828125,1607.199951171875,1622.0,16389,1589.1600036621094,1738.3579296521546,1439.9620776720642,0.0,0.0,18.776954573010755,53.971835761143105,-2.5357500546829836,9.159430200534928,10.473576116041613,3519158,1589.1600036621094,1674.5,1477.300048828125,1.0537013240587672,0.9296106404791142,0.0,3.0,1.0845145937933987,98.30999755859375,99.31999969482422,98.29000091552734,99.18000030517578,0.0,98.89800033569335,103.61398424832304,94.18201642306367,0.0,0.0,9.537066263467478,47.25330282971873,0.8234192700801612,1.7543850036491473,0.3499842711040202,0.0,98.89800033569335,102.81999969482422,94.9000015258789,1.0396570137497045,0.9595745232841525,3.0,0.0,5925.53857421875,6517.19580078125,5903.234375,6429.841796875,37101651525,6026.747290039062,7465.370586114126,4588.123993963998,0.0,0.0,47.74128487029161,48.732399208365315,8.574723804008189,22.743482158719697,-220.6575340815425,-235308752182,6026.747290039062,7911.43017578125,4970.7880859375,1.3127197466628757,0.8247878742407468,0.0,3.0,32
2020-03-31,1618.699951171875,1621.0,1576.0,1583.4000244140625,2874,1585.0100036621093,1729.9395121507746,1440.080495173444,0.0,0.0,18.28751971959935,47.79878176900963,-2.3797765466052723,3.8363170741293953,7.304565563448705,3516284,1585.0100036621093,1674.5,1477.300048828125,1.056460209166584,0.9320446214313322,0.0,3.0,1.0104658739081445,99.25,99.94999694824219,98.88999938964844,98.94999694824219,0.0,98.98800010681153,103.63531601932463,94.34068419429842,0.0,0.0,9.38965512486057,45.856523357000235,-0.23190497703758917,0.20252855518196203,0.233116048688359,0.0,98.98800010681153,102.81999969482422,94.9000015258789,1.038711758838221,0.9587020792770686,3.0,0.0,6430.6064453125,6504.51513671875,6374.162109375,6438.64453125,32786468812,5953.1080078125,7124.206621919802,4782.009393705197,0.0,0.0,39.34410773567096,48.89117843911038,0.13690436954885143,3.9968333293505465,-188.8343014152615,-202522283370,5953.1080078125,6734.8037109375,4970.7880859375,1.1313088393657817,0.8349904082731471,0.0,3.0,33
2020-04-01,1570.0,1600.0,1570.0,1578.199951171875,2158,1580.3799987792968,1719.8651364928655,1440.894861065728,0.0,0.0,17.652101117618376,46.9942238972715,-0.32841184552284686,6.830020917131176,4.381965859591901,3514126,1580.3799987792968,1674.5,1477.300048828125,1.0595552976457576,0.9347752122712311,0.0,3.0,0.9506083589858444,99.01000213623047,99.83999633789062,98.91000366210938,99.66999816894531,0.0,99.10450019836426,103.69722238593948,94.51177801078904,0.0,0.0,9.268443266214108,50.90425309915486,0.7276414784325169,1.6107675502525811,0.20490433520883755,0.0,99.10450019836426,102.81999969482422,94.9000015258789,1.0374907243265759,0.9575750983651623,3.0,0.0,6437.3193359375,6612.57373046875,6202.37353515625,6606.7763671875,40346426265,6034.907421875,7147.190374377316,4922.624469372684,0.0,0.0,36.861640941518814,52.043210659525926,2.6112924097839496,6.581910592576756,-147.45011652199173,-162175857105,6034.907421875,6734.8037109375,5014.47998046875,1.1159746521587977,0.8309124945798736,0.0,2.0,34
2020-04-02,1590.9000244140625,1631.199951171875,1586.0,1625.699951171875,1294,1577.9399963378905,1712.3697322088392,1443.5102604669419,0.0,0.0,17.038637233726938,54.72830702144795,3.009758045216593,9.948598540159242,6.255158877782833,3515420,1577.9399963378905,1664.199951171875,1477.300048828125,1.0546661818790182,0.9362206752200132,0.0,3.0,0.9959565659138536,99.51000213623047,100.41000366210938,99.33999633789062,100.18000030517578,0.0,99.27250022888184,103.7633523347795,94.78164812298418,0.0,0.0,9.047524934989223,54.26038278472289,0.5116907249922864,0.602529085246492,0.2246282416104748,0.0,99.27250022888184,102.81999969482422,94.9000015258789,1.0357349664586195,0.9559545826596314,3.0,0.0,6606.7763671875,7088.24755859375,6595.91845703125,6793.62451171875,47660646124,6096.403295898437,7233.404069512424,4959.40252228445,0.0,0.0,37.300707267150216,55.4368594525199,2.828128789998541,9.839152330746247,-98.08449326025129,-114515210981,6096.403295898437,6793.62451171875,5014.47998046875,1.1143659928616259,0.8225308820763896,0.0,1.0,35
2020-04-03,1624.5,1636.0,1619.800048828125,1633.699951171875,643,1576.6699951171875,1708.4628186708226,1444.8771715635523,0.0,0.0,16.717870443629455,55.931587609547115,0.49209572739625784,10.087597787862197,8.22613450808376,3516063,1576.6699951171875,1664.199951171875,1477.300048828125,1.0555157111670548,0.9369747971377633,0.0,3.0,0.990061193469057,100.19999694824219,100.8499984741211,100.13999938964844,100.58000183105469,0.0,99.50400047302246,103.75693941719523,95.25106152884969,0.0,0.0,8.548277303334807,56.83198664239426,0.3992828155923167,-0.5733509391636507,0.2699715556616269,0.0,99.50400047302246,102.81999969482422,94.9000015258789,1.0333252854763442,0.9537305140973524,3.0,0.0,6797.396484375,7003.220703125,6673.3359375,6733.38720703125,38976504902,6173.054345703125,7263.853334764591,5082.25535664166,0.0,0.0,35.34065724921852,54.0663621752093,-0.8866740365705117,15.490443254567992,-65.05802807822329,-153491715883,6173.054345703125,6793.62451171875,5014.47998046875,1.1005288680874137,0.8123174849350187,0.0,0.0,36
2020-04-06,1629.0999755859375,1696.699951171875,1625.9000244140625,1677.0,1063,1578.4499938964843,1714.5819203319263,1442.3180674610423,0.0,0.0,17.248810790564658,62.00487632077632,2.6504284827250757,12.128913304040049,13.291646505103927,3517126,1578.4499938964843,1677.0,1477.300048828125,1.0624346710282788,0.9359181821030228,0.0,3.0,1.0326990422979376,100.66000366210938,100.93000030517578,100.4800033569336,100.69000244140625,0.0,99.79350051879882,103.5075559073984,96.07944513019925,0.0,0.0,7.4434815279376485,57.561053035378364,0.10936628390236791,-2.01440215238609,0.30838641577908277,0.0,99.79350051879882,102.81999969482422,96.41000366210938,1.0303276181343621,0.9660950178208041,3.0,0.0,6788.0498046875,7271.78125,6782.8896484375,7271.78125,46896904614,6437.955029296875,7306.034799276757,5569.875259316993,0.0,0.0,26.967562402332906,63.658826983879415,7.0776424294876294,8.841680773776336,51.09427052740102,-102919232542,6437.955029296875,7271.78125,5238.4384765625,1.1295172483977713,0.8136805014518126,0.0,0.0,37
2020-04-07,1695.699951171875,1724.4000244140625,1658.0,1664.800048828125,1144,1582.2249938964844,1723.443337442782,1441.0066503501869,0.0,0.0,17.85060204345838,59.44036179511432,-0.7274866530635027,6.241228387244735,15.755009890526253,3515982,1582.2249938964844,1677.0,1477.300048828125,1.0598998287026908,0.9336851930205168,0.0,3.0,1.00036059228089,100.75,100.79000091552734,99.7699966430664,99.9800033569336,0.0,99.97200050354004,103.34603442708855,96.59796657999154,0.0,0.0,6.7499578012926404,51.34233561622196,-0.7051336451062484,-2.7621049857225253,0.2700115834306871,0.0,99.97200050354004,102.81999969482422,96.51000213623047,1.0284879684005455,0.965370320190932,3.0,0.0,7273.64404296875,7427.939453125,7136.71435546875,7176.41455078125,44243482667,6534.853833007813,7267.862342728755,5801.845323286871,0.0,0.0,22.433815000374953,61.003455423891616,-1.3114627068677276,6.84848061870105,84.56680807293742,-147162715209,6534.853833007813,7271.78125,5830.2548828125,1.1127687681811547,0.8921783152002032,0.0,0.0,38
2020-04-08,1669.699951171875,1677.0,1662.5,1665.4000244140625,747,1589.7099975585938,1731.8965662389398,1447.5234288782478,0.0,0.0,17.888365664015428,59.53182069221832,0.03603889766581325,0.3132196961285872,17.357670544482062,3516729,1589.7099975585938,1677.0,1477.300048828125,1.0549093876087225,0.9292890219580282,0.0,2.0,1.0267571050641568,99.91000366210938,100.43000030517578,99.9000015258789,100.12000274658203,0.0,100.15250053405762,103.12925686720399,97.17574420091125,0.0,0.0,5.944447352333655,52.46743069885226,0.14002739042588974,-2.312416007987155,0.24904987402663892,0.0,100.15250053405762,102.81999969482422,97.47000122070312,1.0266343740450043,0.9732158528339261,3.0,0.0,7179.283203125,7356.2236328125,7153.3056640625,7334.0986328125,37563249548,6591.99912109375,7384.701472658222,5799.296769529277,0.0,0.0,24.05043863030572,63.77916319118274,2.197254365887824,13.358998960539834,121.53312118384656,-109599465661,6591.99912109375,7334.0986328125,5830.2548828125,1.1125757904524145,0.8844441232032718,0.0,0.0,39
2020-04-09,1662.699951171875,1736.199951171875,1662.699951171875,1736.199951171875,825,1602.2249938964844,1749.6260759034076,1454.8239118895613,0.0,0.0,18.399548448992224,68.76629392924008,4.251226475316172,6.36524531248668,24.37335376874512,3517554,1602.2249938964844,1736.199951171875,1477.300048828125,1.0836180672413391,0.9220303355994017,0.0,1.0,1.096501152205272,100.12999725341797,100.30000305175781,99.36000061035156,99.5199966430664,0.0,100.25500030517578,102.9862830030678,97.52371760728377,0.0,0.0,5.448671267424069,47.26329103069263,-0.5992869427244529,-2.1820338778419477,0.1772716321456329,0.0,100.25500030517578,102.81999969482422,98.08999633789062,1.0255847526990234,0.9784050275727405,3.0,0.0,7337.96630859375,7341.4482421875,7179.09423828125,7302.08935546875,34815139177,6647.1646728515625,7475.491404480095,5818.83794122303,0.0,0.0,24.922708324395686,62.771408122862155,-0.43644459866604146,16.979535299283565,144.0219588910113,-144414604838,6647.1646728515625,7334.0986328125,5830.2548828125,1.1033424014251554,0.8771040240095908,0.0,0.0,40
2020-04-13,1722.0,1756.800048828125,1710.699951171875,1744.800048828125,696,1626.264990234375,1777.4657897656984,1475.0641907030517,0.0,0.0,18.594853906254542,69.77649943949083,0.3797087700871504,7.445041110685727,33.0419031206427,4095035,1626.264990234375,1744.800048828125,1478.5999755859375,1.0728879114446574,0.9091999055903206,0.0,0.0,1.0732608114863984,99.48999786376953,99.62999725341797,99.13999938964844,99.5,0.0,100.29250030517578,102.9599485397722,97.62505207057936,0.0,0.0,5.319337391090572,47.09032939197899,-0.020093090575679096,-1.5338970855487266,0.1193361397146191,0.0,100.29250030517578,102.81999969482422,98.08999633789062,1.0252012800753558,0.9780391957466087,3.0,0.0,6965.61669921875,6965.61669921875,6668.259765625,6845.03759765625,38619308647,6765.877954101563,7464.960149984461,6066.795758218665,0.0,0.0,20.66493663129426,49.75476784177372,-1.8082418492216368,3.606315958446428,75.60737018322652,-222119272790,6765.877954101563,7334.0986328125,5922.04296875,1.0839832882835958,0.8752807852763559,0.0,0.0,42
2020-04-14,1756.800048828125,1775.0,1739.5,1756.699951171875,675,1640.169989013672,1785.5314361426517,1494.8085418846922,0.0,0.0,17.725168501149557,71.24063747307802,0.6820209772313124,5.558226337818634,36.25677876223676,4095710,1640.169989013672,1756.699951171875,1484.0,1.0710474907715384,0.9047842662286573,0.0,0.0,1.0752892230374191,99.37999725341797,99.43000030517578,98.83000183105469,98.88999938964844,0.0,100.33250045776367,102.88829330027907,97.77670761524827,0.0,0.0,5.094645963879466,41.89387595468243,-0.6130659400518268,-0.5330907152062538,0.021568494815966233,0.0,100.33250045776367,102.81999969482422,98.37000274658203,1.0247925570050722,0.9804400597789569,3.0,0.0,6843.28173828125,6958.55712890625,6793.8212890625,6842.427734375,34110434051,6773.94619140625,7472.651271446605,6075.241111365895,0.0,0.0,20.629188963052744,49.678119102811685,-0.03812781513637953,0.7183679723844945,60.989051658711105,-256229706841,6773.94619140625,7334.0986328125,5922.04296875,1.0826921893942538,0.8742382654682118,0.0,0.0,43
2020-04-15,1739.4000244140625,1744.9000244140625,1722.699951171875,1727.199951171875,642,1652.3299865722656,1783.3853867581288,1521.2745863864025,0.0,0.0,15.863102558313507,62.85368618861979,-1.6792850697309403,6.485816964973798,35.454686206668384,4095068,1652.3299865722656,1756.699951171875,1495.5999755859375,1.0631653274150905,0.9051460590438946,0.0,0.0,1.0299343775622392,98.81999969482422,99.9800033569336,98.81999969482422,99.45999908447266,0.0,100.32650032043458,102.88988361988478,97.76311702098437,0.0,0.0,5.110082164259639,47.86685611024585,0.5763977129560782,1.1080576471047199,-0.0018278141037484374,0.0,100.32650032043458,102.81999969482422,98.37000274658203,1.0248538458575314,0.9804986960812582,3.0,0.0,6845.5615234375,6928.66455078125,6633.40283203125,6642.10986328125,32288311030,6770.229663085937,7470.906706737077,6069.552619434798,0.0,0.0,20.69876735412737,43.90930783860744,-2.9275847531044064,-1.355593268937287,31.768072887273775,-288518017871,6770.229663085937,7334.0986328125,5922.04296875,1.0832865349902392,0.8747181799517676,0.0,0.0,44
2020-04-16,1731.0,1750.5999755859375,1715.0,1720.4000244140625,162,1663.5699890136718,1776.1933171475328,1550.946660879811,0.0,0.0,13.53995670487361,61.01399266902474,-0.39369655801569925,8.652267139549709,33.65825717210055,4094906,1663.5699890136718,1756.699951171875,1567.0,1.0559819922054616,0.9419501495870769,0.0,0.0,1.0333973894493065,99.62999725341797,100.30000305175781,99.61000061035156,100.02999877929688,0.0,100.27000007629394,102.80708539181079,97.73291476077709,0.0,0.0,5.060507257577376,53.210914696642014,0.5730944098844226,0.8570260854059868,0.03023511372148846,0.0,100.27000007629394,102.81999969482422,98.37000274658203,1.0254313315706594,0.9810511885083651,2.0,0.0,6640.4541015625,7134.45068359375,6555.50439453125,7116.80419921875,46783242376,6802.5799560546875,7504.529483799503,6100.630428309872,0.0,0.0,20.63774427583289,57.04346649205227,7.146740203164859,3.629790505248034,50.68593893612615,-241734775495,6802.5799560546875,7334.0986328125,5922.04296875,1.078134866505278,0.8705583774107706,0.0,0.0,45
2020-04-17,1715.699951171875,1725.0,1684.9000244140625,1689.199951171875,223,1669.6799865722655,1773.607423737382,1565.752549407149,0.0,0.0,12.448785156546338,53.09171040929111,-1.8135359683463026,7.033329326716692,29.044301074943405,4094683,1669.6799865722655,1756.699951171875,1578.199951171875,1.0521177502871406,0.9452110367638816,0.0,0.0,1.0142908168661677,99.86000061035156,100.29000091552734,99.62000274658203,99.77999877929688,0.0,100.12099990844726,102.39168172249607,97.85031809439845,0.0,0.0,4.535875223230238,50.679226878637046,-0.24992502554318508,0.8388093548793506,0.03180143494759591,0.0,100.12099990844726,102.81999969482422,98.37000274658203,1.026957379459304,0.9825111898256472,1.0,0.0,7116.552734375,7167.18310546875,7050.33203125,7096.1845703125,32513423567,6845.2794921875,7508.509734081555,6182.049250293446,0.0,0.0,19.37774031435816,56.40599464963539,-0.2897315751431484,4.491965298539362,62.02714569147065,-274248199062,6845.2794921875,7334.0986328125,5922.04296875,1.071409668689626,0.8651280017870435,0.0,0.0,46
2020-04-20,1686.0,1701.5999755859375,1680.0,1701.5999755859375,106,1674.6449829101562,1778.0513280101495,1571.2386378101628,0.0,0.0,12.349643793790419,55.87990237786732,0.6744778572593368,4.156211449070369,22.926275311335303,4497024,1674.6449829101562,1756.699951171875,1578.199951171875,1.0489984259942222,0.9424086700629041,0.0,0.0,0.9789437483522755,99.70999908447266,100.06999969482422,99.6500015258789,99.95999908447266,0.0,99.97799987792969,101.8812770909051,98.07472266495428,0.0,0.0,3.8073920568510244,52.48767651993911,0.18039718117648373,0.29096109246011886,0.04799468729991929,0.0,99.97799987792969,102.48999786376953,98.37000274658203,1.0251255075007193,0.983916490294755,0.0,0.0,7186.87353515625,7240.29052734375,6835.5029296875,6881.95849609375,37747113935,6972.2054443359375,7414.179393477961,6530.231495193914,0.0,0.0,12.678167695160875,48.2179482442476,-4.276646838190478,-6.16490395555755,69.77004076781122,-310859334827,6972.2054443359375,7334.0986328125,6606.7763671875,1.0519051240480237,0.9475877353204927,0.0,0.0,48
2020-04-21,1697.0,1707.0999755859375,1659.9000244140625,1678.199951171875,666,1676.049981689453,1778.845955363614,1573.2540080152921,0.0,0.0,12.266456823744946,49.64261757540499,-1.3751777591560432,0.0715534389907573,18.810963853590692,4496358,1676.049981689453,1756.699951171875,1578.199951171875,1.0481190718436255,0.9416186679475123,0.0,0.0,0.961829381136835,99.94000244140625,100.4800033569336,99.93000030517578,100.26000213623047,0.0,99.86650009155274,101.39182419434127,98.3411759887642,0.0,0.0,3.054726262340601,55.508748598452016,0.3001231037470298,0.07985808625571966,0.08512511343934648,0.0,99.86650009155274,101.73999786376953,98.37000274658203,1.0187600223348097,0.9850150216178719,0.0,0.0,6879.7841796875,6934.5517578125,6834.4423828125,6880.3232421875,32589741510,6985.882788085937,7397.67579254472,6574.089783627154,0.0,0.0,11.789290400379308,48.1705044030761,-0.023761461322069355,-5.775964833481213,52.15120443595424,-343449076337,6985.882788085937,7334.0986328125,6642.10986328125,1.0498456466118251,0.9507903388543859,0.0,0.0,49
2020-04-22,1696.0,1728.699951171875,1684.800048828125,1728.699951171875,453,1681.2899780273438,1783.6015717284945,1578.978384326193,0.0,0.0,12.17060650313194,60.27511223474918,3.0091765861830932,3.8382929162412025,19.811127859267344,4496811,1681.2899780273438,1756.699951171875,1578.199951171875,1.044852449089722,0.9386839699262205,0.0,0.0,0.9840610230669605,100.20999908447266,100.5,99.9000015258789,100.38999938964844,0.0,99.79900016784669,101.08787571741206,98.51012461828131,0.0,0.0,2.5829428098431517,56.83034660330775,0.12966013429895895,-0.18890677863120262,0.12239241856678973,0.0,99.79900016784669,101.05000305175781,98.37000274658203,1.0125352246195567,0.9856812451140663,0.0,0.0,6879.4404296875,7145.86572265625,6867.78173828125,7117.20751953125,33249153865,7002.061938476562,7407.750251030968,6596.373625922157,0.0,0.0,11.587681346408399,55.25662287672744,3.4429236680519004,3.6663696176459917,58.715099312074926,-310199922472,7002.061938476562,7334.0986328125,6642.10986328125,1.0474198453617476,0.948593417430748,0.0,0.0,50
2020-04-23,1734.0,1745.0999755859375,1733.300048828125,1733.300048828125,482,1684.7449829101563,1789.1600663993947,1580.3298994209179,0.0,0.0,12.39535770082856,61.10627246974054,0.2661015668526945,4.077100001121458,20.606736026620865,4497293,1684.7449829101563,1756.699951171875,1578.199951171875,1.0427097091795026,0.9367589559137669,0.0,0.0,1.0035317842917442,100.44999694824219,100.69000244140625,100.04000091552734,100.43000030517578,0.0,99.76800003051758,100.96130918566591,98.57469087536926,0.0,0.0,2.392168139650612,57.26436502132804,0.03984551824935956,-0.25822040910344574,0.15132383767101487,0.0,99.76800003051758,100.69000244140625,98.37000274658203,1.00924146430325,0.9859875182071614,0.0,0.0,7121.30615234375,7491.78515625,7081.5947265625,7429.724609375,43500782316,7036.87880859375,7463.348032473701,6610.4095847138,0.0,0.0,12.120976798950338,62.72668870395987,4.391007132869618,8.319502780656522,89.6151314481931,-266699140156,7036.87880859375,7429.724609375,6642.10986328125,1.0558267111693738,0.943899993725856,0.0,0.0,51
2020-04-24,1744.0,1744.0,1714.5,1723.5,221,1689.8199829101563,1791.3704179358729,1588.2695478844398,0.0,0.0,12.019083222205653,58.22268590616983,-0.5653982895085452,-0.731479756309345,19.990377048043,4497072,1689.8199829101563,1756.699951171875,1578.199951171875,1.0395781615427107,0.9339456078948405,0.0,0.0,1.0018018923168717,100.5,100.87000274658203,100.22000122070312,100.37999725341797,0.0,99.81599998474121,101.02656093668661,98.60543903279581,0.0,0.0,2.425584980625258,56.47573096363423,-0.04978895908182013,0.40007389783372665,0.16579100771855337,0.0,99.81599998474121,100.69000244140625,98.37000274658203,1.008756135857965,0.9855133722210845,0.0,0.0,7434.181640625,7574.19580078125,7434.181640625,7550.90087890625,34636526285,7071.0474853515625,7544.665220509329,6597.429750193796,1.0,0.0,13.39597099691146,65.22777913873043,1.6309658285092787,8.31733534610987,121.42885595082589,-232062613871,7071.0474853515625,7550.90087890625,6642.10986328125,1.0678617127870738,0.9393388853689778,1.0,0.0,52
2020-04-27,1731.9000244140625,1731.9000244140625,1711.9000244140625,1711.9000244140625,169,1704.4049865722657,1777.441686245622,1631.3682868989094,0.0,0.0,8.570345692339302,53.337695151295435,-1.6940392549911643,-1.88560428091227,18.377780700879157,4765937,1704.4049865722657,1756.699951171875,1625.699951171875,1.030682241023467,0.9538225738480884,0.0,0.0,1.0128387610159035,100.2300033569336,100.31999969482422,99.83000183105469,100.04000091552734,0.0,99.89949989318848,100.91410452573159,98.88489526064537,0.0,0.0,2.031250674183387,51.15341192081733,-0.33870925203581814,-0.07990594172992935,0.14419271892825236,0.0,99.89949989318848,100.69000244140625,98.88999938964844,1.0079129780335534,0.9898948392672697,0.0,0.0,7679.4189453125,7795.60107421875,7679.4189453125,7795.60107421875,36162144724,7161.3514404296875,7789.563415307561,6533.139465551814,1.0,0.0,17.544509024687105,70.40100842045175,1.5069777105927384,17.3663374241098,193.58623495945358,-129888773211,7161.3514404296875,7795.60107421875,6642.10986328125,1.0885656344427368,0.9274939120824264,2.0,0.0,54
2020-04-28,1716.5999755859375,1716.5999755859375,1707.0999755859375,1710.5,1255,1708.6449890136719,1772.1350066119135,1645.1549714154303,0.0,0.0,7.43162189998189,52.952465499576974,-0.08178190280367925,-2.629928414414512,16.19135122668399,4764682,1708.6449890136719,1756.699951171875,1633.699951171875,1.028124603101984,0.9561377358528647,0.0,0.0,1.0052303858378921,100.05999755859375,100.20999908447266,99.44999694824219,99.87000274658203,0.0,99.93400001525879,100.89384355021018,98.9741564803074,0.0,0.0,1.9209548998435608,48.6084665778726,-0.1699301953114296,0.35169424771077906,0.11098907547474823,0.0,99.93400001525879,100.69000244140625,98.88999938964844,1.0075650171716535,0.9895530987906924,0.0,0.0,7796.97021484375,7814.52734375,7730.806640625,7807.05859375,33187959920,7184.999438476562,7870.442799526935,6499.556077426189,0.0,0.0,19.079844526632495,70.64266328869088,0.1469741643032707,9.69893754568972,209.6951181479717,-96700813291,7184.999438476562,7807.05859375,6642.10986328125,1.0865774814041367,0.9244412501568099,2.0,0.0,55
2020-04-29,1710.0,1713.5,1702.0,1703.4000244140625,373,1712.1299926757813,1765.6514979221204,1658.6084874294422,0.0,0.0,6.2520375760363445,50.881723401555064,-0.41508188166836657,-1.3779485543445427,13.67773929286227,4764309,1712.1299926757813,1756.699951171875,1664.800048828125,1.026031877653424,0.972356103771252,0.0,0.0,1.0150161327466316,99.87999725341797,99.88999938964844,99.47000122070312,99.56999969482422,0.0,99.96500015258789,100.83120013931496,99.09880016586082,0.0,0.0,1.7330065230928604,44.28801639422562,-0.3003935551289194,0.07035145208464197,0.05851357604790053,0.0,99.96500015258789,100.69000244140625,98.88999938964844,1.0072525612735628,0.9892462285670128,0.0,0.0,7806.71240234375,8871.75390625,7786.04931640625,8801.0380859375,60201052202,7259.946875,8243.277084302816,6276.616665697183,1.0,0.0,27.089184707093782,83.57152338217945,12.731805202323422,24.024931971998047,304.0476220284663,-36499761089,7259.946875,8801.0380859375,6642.10986328125,1.2122730699647855,0.9148978605000123,3.0,0.0,56
2020-04-30,1719.300048828125,1719.300048828125,1680.800048828125,1684.199951171875,327,1712.489990234375,1765.1514305628261,1659.8285499059239,0.0,0.0,6.150277155341945,45.53168311771906,-1.1271617334156159,-2.1041660502484936,9.91782560152592,4763982,1712.489990234375,1756.699951171875,1664.800048828125,1.0258161864826136,0.9721516962562081,0.0,0.0,0.9742581123058205,99.4800033569336,99.7300033569336,98.80999755859375,99.0199966430664,0.0,99.93250007629395,100.88501175060587,98.97998840198203,0.0,0.0,1.906310106491325,37.49864490737108,-0.5523782800477384,0.13145642048772885,-0.028964457464411453,0.0,99.93250007629395,100.69000244140625,98.88999938964844,1.0075801402400018,0.9895679515087723,0.0,0.0,8797.669921875,9440.650390625,8533.255859375,8658.5537109375,66964629541,7349.59990234375,8487.531846517773,6211.667958169726,1.0,0.0,30.96582016147962,78.093713385292,-1.6189496467202469,19.302195187227298,356.29177863214954,-103464390630,7349.59990234375,8801.0380859375,6642.10986328125,1.1974853329268842,0.9037376117798079,4.0,0.0,57
2020-05-01,1686.5999755859375,1701.5,1670.5,1694.5,337,1713.9749877929687,1762.701451587617,1665.2485239983205,0.0,0.0,5.685784698339356,48.744107601698175,0.6115692392080874,0.31376089162494436,7.854554748443206,4764319,1713.9749877929687,1756.699951171875,1665.4000244140625,1.0249274135755748,0.9716594677723654,0.0,0.0,0.9776149265937207,99.12999725341797,99.20999908447266,98.77999877929688,98.80000305175781,0.0,99.86350021362304,100.92768684902278,98.7993135782233,0.0,0.0,2.131282466813762,35.10677941001573,-0.22217087332531138,-0.6635793673739134,-0.11226643896621624,0.0,99.86350021362304,100.69000244140625,98.80000305175781,1.0082763194361823,0.9893504918254392,0.0,0.0,8672.7822265625,9048.0234375,8667.763671875,8864.7666015625,44068389996,7449.88408203125,8740.49870433702,6159.2694597254795,1.0,0.0,34.647911513648076,80.1825413152842,2.3816089558295506,23.302862779546402,406.65039974557476,-59396000634,7449.88408203125,8864.7666015625,6642.10986328125,1.1899200717691536,0.8915722432919042,5.0,0.0,58
2020-05-04,1702.5999755859375,1709.0,1699.5999755859375,1706.9000244140625,320,1714.4849914550782,1757.2519724044837,1671.7180105056727,0.0,0.0,4.9889011758696435,52.55424959353558,0.1173089313953879,0.31147443019326293,6.577218245561653,5198631,1714.4849914550782,1756.699951171875,1678.199951171875,1.0246225309216437,0.9788361866892703,0.0,0.0,0.980188354475527,99.08999633789062,99.5999984741211,99.08999633789062,99.4800033569336,0.0,99.80850028991699,100.83179510706131,98.78520547277267,0.0,0.0,2.0505163671870044,46.76814364812131,0.6882593969349982,-0.5498304799310998,-0.11311304925813204,0.0,99.80850028991699,100.69000244140625,98.80000305175781,1.0088319346441308,0.989895677870825,0.0,0.0,8895.7451171875,8956.90625,8645.0244140625,8912.654296875,45718796275,7756.8922119140625,9311.37609246921,6202.408331358915,0.0,0.0,40.08006913303669,77.76576443928181,0.17067266322232655,25.2268431462288,466.46354131021053,-20644600850,7756.8922119140625,8988.5966796875,6642.10986328125,1.1587883954197047,0.8562849246608607,6.0,0.0,60
2020-05-05,1701.5,1704.4000244140625,1697.199951171875,1704.4000244140625,82,1712.7949951171875,1754.3335526054814,1671.2564376288935,0.0,0.0,4.850382866217086,51.616038934604404,-0.14646434848216705,1.5612009298350997,5.8660830739495395,5198549,1712.7949951171875,1756.699951171875,1678.199951171875,1.025633514915592,0.9798019937914721,0.0,0.0,0.995618903035785,99.51000213623047,99.97000122070312,99.30000305175781,99.70999908447266,0.0,99.7595001220703,100.69974450832166,98.81925573581896,0.0,0.0,1.8850222487097963,50.13564943622097,0.23119794911328206,-0.0701540345566158,-0.09186804324990305,0.0,99.7595001220703,100.43000030517578,98.80000305175781,1.0067211662276276,0.9903818977727594,0.0,0.0,8912.83203125,9062.4150390625,8856.8271484375,9003.0703125,43148462663,7874.940234375,9431.450056762695,6318.430411987305,0.0,0.0,39.53070819746299,78.95737584354715,1.0144678859214995,21.176366364100705,469.30583629103876,22503861813,7874.940234375,9003.0703125,6880.3232421875,1.1432557003036778,0.8736984710251026,6.0,0.0,61
2020-05-06,1704.0,1704.0,1684.199951171875,1684.199951171875,469,1709.764990234375,1750.3531492821528,1669.1768311865974,0.0,0.0,4.747805608326776,44.48607916050695,-1.185172081250807,-2.57418876941795,3.4891570502043123,5198080,1709.764990234375,1756.699951171875,1678.199951171875,1.0274511182563553,0.9815383755996939,0.0,0.0,0.9846243502904852,99.80000305175781,100.19999694824219,99.75,100.08999633789062,0.0,99.76499977111817,100.71160408958278,98.81839545265356,0.0,0.0,1.8976681614520465,55.323998807665475,0.38110245402374066,0.13004927431833274,-0.041650236891612735,0.0,99.76499977111817,100.43000030517578,98.80000305175781,1.0066656696795797,0.9903273019438253,0.0,0.0,9007.44140625,9411.4677734375,8966.7060546875,9268.76171875,49371886931,7982.538110351563,9610.422391260769,6354.653829442357,0.0,0.0,40.78613239060405,82.09116280868272,2.9511199738283755,22.75040908883686,486.28694980427645,71875748744,7982.538110351563,9268.76171875,6880.3232421875,1.161129654580727,0.8619217530906946,6.0,0.0,62
2020-05-07,1686.199951171875,1721.800048828125,1685.5999755859375,1721.800048828125,853,1708.0199951171876,1743.0001185944102,1673.039871639965,0.0,0.0,4.095985243407249,56.82171001091415,2.23251981631325,-0.6634742788921681,4.924615815847801,5198933,1708.0199951171876,1741.4000244140625,1678.199951171875,1.0195431138934556,0.9825411622635796,0.0,0.0,1.0108019397383723,100.20999908447266,100.4000015258789,99.80999755859375,99.88999938964844,0.0,99.75349960327148,100.68808522198319,98.81891398455977,0.0,0.0,1.8737901375463273,52.15077837364972,-0.1998171201515686,-0.36904322631001135,-0.021070553471744802,0.0,99.75349960327148,100.43000030517578,98.80000305175781,1.0067817239955972,0.9904414726770909,0.0,0.0,9261.8955078125,9992.6640625,9138.322265625,9951.5185546875,61112700562,8125.3048095703125,9910.446313444872,6340.163305695753,1.0,0.0,43.94029628948684,87.43435156404546,7.366214135771076,31.461065304524627,549.5499772081566,132988449306,8125.3048095703125,9951.5185546875,6880.3232421875,1.2247563368904264,0.8467772475542797,7.0,0.0,63
2020-05-08,1726.199951171875,1728.9000244140625,1703.800048828125,1709.9000244140625,330,1707.1549987792969,1741.0334421172508,1673.276555441343,0.0,0.0,3.968994421968572,52.70344019120394,-0.6911385803573311,-0.7890905474869451,4.871648272040147,5198603,1707.1549987792969,1741.4000244140625,1678.199951171875,1.0200597049824138,0.983039004877632,0.0,0.0,1.0152595143019125,99.83999633789062,99.94000244140625,99.45999908447266,99.7300033569336,0.0,99.76399993896484,100.69255523550757,98.83544464242212,0.0,0.0,1.8615037430552335,49.62092766235367,-0.16017222313791102,-0.6574320517257601,-0.01932385466487574,0.0,99.76399993896484,100.43000030517578,98.80000305175781,1.0066757584561403,0.9903372269776993,0.0,0.0,9936.162109375,9996.7431640625,9767.1728515625,9842.666015625,51780748041,8254.554858398438,10141.142793403375,6367.966923393502,0.0,0.0,45.71022828894192,83.04522800264073,-1.0938284289408906,28.1619300870885,577.4405702643508,81207701265,8254.554858398438,9951.5185546875,6880.3232421875,1.2055790682113547,0.8335183859354024,7.0,0.0,64
2020-05-11,1702.300048828125,1704.5,1690.199951171875,1695.300048828125,749,1706.8600036621094,1739.6663434797638,1674.053663844455,0.0,0.0,3.844057479496569,47.53833997783635,-0.7667979043977424,-0.9696813686079143,3.216435300844978,4877269,1706.8600036621094,1741.4000244140625,1678.199951171875,1.0202360010064369,0.9832089026465302,0.0,0.0,0.9943691856129588,99.66999816894531,100.27999877929688,99.66999816894531,100.23999786376953,0.0,99.80099983215332,100.74339814586293,98.85860151844372,0.0,0.0,1.8885548547500353,57.00746543475492,0.5113752027167573,-0.18918892843661378,0.026459136899433133,0.0,99.80099983215332,100.43000030517578,98.80000305175781,1.006302546808953,0.9899700726237313,0.0,0.0,8755.53515625,9033.470703125,8374.3232421875,8601.7958984375,57119858801,8554.57568359375,10182.769565578405,6926.381801609095,0.0,0.0,38.0660348848689,48.78996619206258,-1.7659566044374797,-2.263848713691556,387.6301387147614,-85803558713,8554.57568359375,9951.5185546875,7117.20751953125,1.1632977394510464,0.8319766850833838,7.0,0.0,66
2020-05-12,1699.300048828125,1713.0999755859375,1699.300048828125,1704.4000244140625,324,1707.5700073242188,1739.5064808492539,1675.6335337991836,0.0,0.0,3.740575600186365,50.90506089850676,0.5367766957965925,-0.3566194437847121,2.9109381171419955,4877593,1707.5700073242188,1741.4000244140625,1678.199951171875,1.0198117892354268,0.9828000866574326,0.0,0.0,0.9985353565151783,100.2300033569336,100.44000244140625,99.66000366210938,99.93000030517578,0.0,99.85299987792969,100.69836513969463,99.00763461616475,0.0,0.0,1.6932195583475684,51.870986298176014,-0.3092553523545094,-0.4482934454621785,0.03305266000774054,0.0,99.85299987792969,100.43000030517578,98.80000305175781,1.0057784986725633,0.9894545298843384,0.0,0.0,8610.3857421875,8949.8984375,8569.6435546875,8804.4775390625,42142717533,8638.939184570312,10129.52002967917,7148.358339461454,0.0,0.0,34.508423158508364,52.74512543071419,2.3562712138033515,1.6853141182304934,332.92447612824253,-43660841180,8638.939184570312,9951.5185546875,7429.724609375,1.1519375634061109,0.8600274235805427,7.0,0.0,67
2020-05-13,1702.0,1721.300048828125,1701.9000244140625,1713.9000244140625,431,1708.185009765625,1740.1116600234245,1676.2583595078254,0.0,0.0,3.7380787297952143,54.306483110022576,0.5573808885191767,0.6164142215280173,3.456895818952489,4878024,1708.185009765625,1741.4000244140625,1678.199951171875,1.0194446236552532,0.9824462465000415,0.0,0.0,1.0055738088851918,100.01000213623047,100.27999877929688,99.58000183105469,100.23999786376953,0.0,99.89199981689453,100.73320253224863,99.05079710154043,0.0,0.0,1.684224396139939,56.250852843326825,0.3102147079426132,0.19991697962004487,0.06420085474094606,0.0,99.89199981689453,100.43000030517578,98.80000305175781,1.0053858215799807,0.9890682260127099,0.0,0.0,8805.3876953125,9317.87890625,8805.3876953125,9269.9873046875,45558144023,8730.952319335938,10136.35971797008,7325.544920701798,0.0,0.0,32.19367938871148,60.52545388529024,5.287193516704303,4.571137869028339,326.96702636933696,1897302843,8730.952319335938,9951.5185546875,7550.90087890625,1.13979760634455,0.86484275743709,7.0,0.0,68
2020-05-14,1724.300048828125,1743.0999755859375,1720.5,1738.0999755859375,672,1711.1800109863282,1742.5263210669066,1679.8337009057498,0.0,0.0,3.6637069015912966,61.79783458343666,1.411981494086767,3.200334044455861,5.896420525321446,4878696,1711.1800109863282,1741.4000244140625,1684.199951171875,1.0176603356944987,0.984233067449811,0.0,0.0,1.0320033404445585,100.19000244140625,100.55999755859375,100.1500015258789,100.47000122070312,0.0,99.91399993896485,100.79075210957566,99.03724776835404,0.0,0.0,1.7550136540352739,59.30394307458195,0.2294526754142323,0.6007794709324049,0.10606061672832823,0.0,99.91399993896485,100.47000122070312,98.80000305175781,1.0055647985475302,0.988850442501676,0.0,0.0,9271.3291015625,9793.2685546875,9255.03515625,9733.7216796875,56426907637,8840.093359375,10200.287421725036,7479.899297024965,0.0,0.0,30.773296322884132,66.61044480591457,5.002535168149658,8.289669973554819,357.04536180548166,58324210480,8840.093359375,9951.5185546875,7569.93603515625,1.125725504259955,0.8563185621934936,6.0,0.0,69
2020-05-15,1739.699951171875,1753.4000244140625,1739.699951171875,1753.4000244140625,719,1712.4150146484376,1748.0746061412276,1676.7554231556476,1.0,0.0,4.164830509864573,65.743207854672,0.8802743825462089,3.4759530489266743,8.924879483115092,4879415,1712.4150146484376,1753.4000244140625,1684.199951171875,1.0239340401801131,0.9835232328406351,1.0,0.0,1.018352871814265,100.26000213623047,100.48999786376953,100.08000183105469,100.4000015258789,0.0,99.94500007629395,100.84416556770874,99.04583458487916,0.0,0.0,1.7993206077910953,57.93670758646555,-0.06967223447170712,0.8335862544929104,0.1291505861501605,0.0,99.94500007629395,100.47000122070312,98.80000305175781,1.0052529005353785,0.9885437288142269,0.0,0.0,9734.291015625,9755.828125,9261.3984375,9328.197265625,48158802327,8928.006420898437,10170.665755033337,7685.347086763537,0.0,0.0,27.837330654828303,57.93331011247502,-4.166180495059313,4.841023078895332,338.0182000353889,10165408153,8928.006420898437,9951.5185546875,7679.8671875,1.1146406135409193,0.8601995591673381,6.0,0.0,70
2020-05-18,1755.699951171875,1770.5,1731.800048828125,1731.800048828125,229,1714.4950134277344,1756.9784982606452,1672.0115285948236,0.0,0.0,4.955801504254588,54.458698888443664,-1.9698815373452194,1.4587863411982829,11.32273208477227,5668276,1714.4950134277344,1766.5999755859375,1684.199951171875,1.0303908508045359,0.9823300376970525,2.0,0.0,1.013697040552366,100.36000061035156,100.47000122070312,99.58000183105469,99.66999816894531,0.0,99.93050003051758,100.83754897704745,99.02345108398771,0.0,0.0,1.8153595674050813,45.72226417112471,-0.7270949659751058,0.6564346070642093,0.08080303328375749,0.0,99.93050003051758,100.47000122070312,98.80000305175781,1.0053987640412165,0.988687167797474,0.0,0.0,9675.6953125,9906.0302734375,9570.359375,9726.5751953125,41827139895,9202.596484375,10040.125142268553,8365.067826481449,0.0,0.0,18.2020076467676,63.689083037932775,0.5773698991511145,4.939316496144012,335.72068906025925,128241565117,9202.596484375,9951.5185546875,8601.7958984375,1.0813816048094782,0.9347140139244838,5.0,0.0,72
2020-05-19,1744.199951171875,1749.5,1744.199951171875,1744.199951171875,167,1714.635009765625,1757.4890507616785,1671.7809687695715,0.0,0.0,4.998619618983668,57.935729174784704,0.7160123567464316,2.3351282672912945,11.584131537062376,5668443,1714.635009765625,1766.5999755859375,1684.199951171875,1.0303067215613517,0.9822498325180528,2.0,0.0,1.0288443938744365,99.62000274658203,99.7300033569336,99.2300033569336,99.37000274658203,0.0,99.88600006103516,100.81116702747484,98.96083309459549,0.0,0.0,1.8524457198693594,41.70732080100906,-0.3009886905533721,0.5769227502205807,0.017640469991306418,0.0,99.88600006103516,100.47000122070312,98.80000305175781,1.0058466768046683,0.9891276354182392,0.0,0.0,9727.0634765625,9836.0478515625,9539.6240234375,9729.0380859375,39254288954,9248.996484375,10095.176568809145,8402.816399940855,0.0,0.0,18.29777070114922,63.72683820332082,0.025321252090737545,-2.235643409871393,333.9663093386789,167495854071,9248.996484375,9951.5185546875,8601.7958984375,1.0759565723156368,0.9300247776036176,4.0,0.0,73
2020-05-20,1751.5999755859375,1752.0999755859375,1745.5999755859375,1750.5999755859375,16,1716.5700073242188,1762.1626787945436,1670.977335853894,0.0,0.0,5.312066653360031,59.70024789566527,0.36693180789062474,3.942526204674274,12.131158673315895,5668459,1716.5700073242188,1766.5999755859375,1684.199951171875,1.0291453119000402,0.9811425948174395,2.0,0.0,1.0271062840354968,99.55000305175781,99.55999755859375,99.0,99.12000274658203,0.0,99.82250022888184,100.77452560331182,98.87047485445186,0.0,0.0,1.9074364441826073,38.57116704727495,-0.25158497845427785,-0.36188238661380284,-0.05106671703455845,0.0,99.82250022888184,100.47000122070312,98.80000305175781,1.006486523482548,0.9897568466550172,0.0,0.0,9725.3291015625,9804.7939453125,9447.201171875,9522.9814453125,36546239702,9292.21787109375,10100.819998370498,8483.615743817001,0.0,0.0,17.40385639885069,58.11003417237303,-2.117954918100662,-3.247946946538756,309.04424448047394,130949614369,9292.21787109375,9951.5185546875,8601.7958984375,1.0709519183406906,0.9256989039393905,3.0,0.0,74
2020-05-21,1746.800048828125,1746.800048828125,1720.5,1720.5,528,1717.0700073242188,1762.604737613352,1671.5352770350855,0.0,0.0,5.3037709697220645,48.966447682197995,-1.7194091172006765,-0.07550521496441046,9.719978993174664,5667931,1717.0700073242188,1766.5999755859375,1684.199951171875,1.0288456312500056,0.9808568922570802,2.0,0.0,1.0038508521453542,99.18000030517578,99.51000213623047,99.0199966430664,99.37000274658203,0.0,99.76950035095214,100.69807769887443,98.84092300302986,0.0,0.0,1.8614453207761776,43.30776097556251,0.25221952489162813,-0.3409851980868897,-0.0793985876548362,0.0,99.76950035095214,100.47000122070312,98.80000305175781,1.0070211925216312,0.9902826285008545,0.0,0.0,9522.740234375,9555.2421875,8869.9306640625,9081.76171875,39326160532,9303.067626953125,10094.068241538691,8512.067012367559,0.0,0.0,17.005156713982288,48.036841502160364,-4.633209978369557,-5.338131034237058,247.04318560634238,91623453837,9303.067626953125,9951.5185546875,8601.7958984375,1.0697029145371,0.9246193022950968,2.0,0.0,75
2020-05-22,1726.5999755859375,1734.5999755859375,1726.5999755859375,1734.5999755859375,6,1718.6300048828125,1764.3220563126993,1672.9379534529257,0.0,0.0,5.317264483928563,53.33353600837998,0.8195277876162477,1.4445260435819351,8.98754553188428,5667937,1718.6300048828125,1766.5999755859375,1684.199951171875,1.0279117498046917,0.9799665701092626,2.0,0.0,0.9979863068585453,99.41999816894531,99.87000274658203,99.38999938964844,99.86000061035156,0.0,99.74350051879883,100.63043269872725,98.8565683388704,0.0,0.0,1.778426013354646,51.45884972069267,0.493104407996392,-0.22978892592085554,-0.05657260605335068,0.0,99.74350051879883,100.47000122070312,98.80000305175781,1.0072836896451953,0.9905407624343083,0.0,0.0,9080.3349609375,9232.9365234375,9008.638671875,9182.5771484375,29810773699,9312.766650390626,10092.786447447043,8532.746853334209,0.0,0.0,16.751623364764512,50.227308484077525,1.110086707949609,4.866668859995194,205.5971024195369,121434227536,9312.766650390626,9951.5185546875,8601.7958984375,1.0685888445696297,0.9236563334352091,1.0,0.0,76
2020-05-26,1726.4000244140625,1726.4000244140625,1704.800048828125,1704.800048828125,39,1721.4650085449218,1763.5243358172386,1679.405681272605,0.0,0.0,4.886457414300583,43.70590998502497,-1.4908082238402454,0.5603727792355618,4.799162954949679,5558371,1721.4650085449218,1766.5999755859375,1684.199951171875,1.0262189279578597,0.9783527070326307,2.0,0.0,0.9650175888079502,99.7699966430664,99.7699966430664,98.9000015258789,99.01000213623047,0.0,99.69200057983399,100.62262466899841,98.76137649066956,0.0,0.0,1.8669985229540567,40.29277276559225,-0.8511901351149986,-0.8809663217488841,-0.11228878009818288,0.0,99.69200057983399,100.47000122070312,98.80000305175781,1.007804042815312,0.9910524663675311,0.0,0.0,8909.5859375,8991.9677734375,8757.2939453125,8835.052734375,29584186947,9295.751025390626,10105.994414577215,8485.507636204036,0.0,0.0,17.43255358224359,43.35557294806799,-0.8070322664891605,-9.23253175800021,36.45841940996797,118347261365,9295.751025390626,9951.5185546875,8601.7958984375,1.0705448680268754,0.9253470617857943,1.0,0.0,78
2020-05-27,1685.5999755859375,1710.300048828125,1685.5999755859375,1710.300048828125,137416,1721.735009765625,1763.433294301173,1680.0367252300769,0.0,0.0,4.843751715454091,45.74181732805588,0.3226184797320286,0.34616430002051934,2.864694733655597,5695787,1721.735009765625,1766.5999755859375,1684.199951171875,1.0260579970586878,0.9781992824790968,2.0,0.0,0.9875851718478997,99.0199966430664,99.33999633789062,98.72000122070312,99.05999755859375,0.0,99.65150032043456,100.61744479129476,98.68555584957437,0.0,0.0,1.9386451137296465,41.12764788041444,0.05049532500209786,-0.671819688947461,-0.14726021816747448,0.0,99.65150032043456,100.47000122070312,98.80000305175781,1.0082136334890757,0.99145524888297,0.0,0.0,8837.380859375,9203.3203125,8834.1572265625,9181.017578125,32740536902,9257.2259765625,10010.342285282473,8504.109667842527,0.0,0.0,16.270885265774375,52.103441194401164,3.9158209254817056,-1.5777934718679942,39.20514297313093,151087798267,9257.2259765625,9842.666015625,8601.7958984375,1.063241411686905,0.9291980038313398,0.0,0.0,79
2020-05-28,1709.300048828125,1727.800048828125,1705.0,1713.300048828125,23355,1722.0550109863282,1763.3896415666266,1680.7203804060298,0.0,0.0,4.800616741810526,46.90556877536485,0.17540781818112805,-0.035006451799463385,1.642820946746724,5719142,1722.0550109863282,1766.5999755859375,1684.199951171875,1.0258673296238636,0.9780175083995887,2.0,0.0,0.9822841972200553,98.91000366210938,99.08999633789062,98.3499984741211,98.37999725341797,0.0,99.59200019836426,100.70595854685465,98.47804184987388,0.0,1.0,2.237043831375286,33.95288364559583,-0.6864529799463837,-1.8555473363830108,-0.22947269063801912,0.0,99.59200019836426,100.47000122070312,98.37999725341797,1.0088159794018605,0.9878303182732322,0.0,1.0,9184.9453125,9546.3193359375,9148.45703125,9525.7509765625,34367073114,9241.380224609375,9956.958976598042,8525.801472620708,0.0,0.0,15.486404294525476,59.097149328645976,3.7548495632866885,1.5861905494882245,70.40660239373028,185454871381,9241.380224609375,9733.7216796875,8601.7958984375,1.0532757491967533,0.9307912551343044,0.0,0.0,80
2020-05-29,1718.800048828125,1738.300048828125,1715.0999755859375,1736.9000244140625,1526,1723.6800109863282,1764.6644514457305,1682.6955705269258,0.0,0.0,4.75545811266328,55.28794925532249,1.3774572411924924,-0.06903809842529224,2.7531577881770772,5720668,1723.6800109863282,1766.5999755859375,1684.199951171875,1.0249001928003154,0.9770954820135892,2.0,0.0,0.9921741395162024,98.5199966430664,98.55000305175781,97.94999694824219,98.33999633789062,0.0,99.55800018310546,100.7763368844711,98.33966348173982,0.0,0.0,2.447491309839287,33.57010754935283,-0.04065960219973297,-1.5911177448508458,-0.2898210038001565,0.0,99.55800018310546,100.47000122070312,98.33999633789062,1.0091604997681787,0.9877658867898641,0.0,1.0,9528.35546875,9573.6669921875,9379.3388671875,9439.1240234375,32896642044,9233.6416015625,9937.047874257149,8530.235328867851,0.0,0.0,15.235728286781663,56.78219443210144,-0.9093976247976698,-2.3950106418998915,84.78445559220381,152558229337,9233.6416015625,9733.7216796875,8601.7958984375,1.0541584891101228,0.9315713420133093,0.0,0.0,81
2020-06-01,1740.4000244140625,1747.0,1727.0999755859375,1737.800048828125,871,1728.030010986328,1767.1473844056584,1688.9126375669978,0.0,0.0,4.527395145990876,53.83200676976599,-0.9913344819849623,-1.6302460747097132,5.2628601536321185,6316596,1728.030010986328,1766.5999755859375,1695.300048828125,1.0223201937202435,0.9810593786276192,2.0,0.0,1.0018448479691155,98.30000305175781,98.31999969482422,97.79000091552734,97.81999969482422,0.0,99.50900001525879,100.91041268157997,98.10758734893761,0.0,1.0,2.8166551087967613,28.869113598496526,-0.5287743160775848,-2.4142041306048254,-0.3744972392843948,0.0,99.50900001525879,100.47000122070312,97.81999969482422,1.0096574300344388,0.9830266576874898,0.0,2.0,9463.60546875,10199.5654296875,9450.8994140625,10167.2685546875,35198901068,9391.94345703125,10070.592941771643,8713.293972290856,1.0,0.0,14.451737020037633,66.77543516773946,7.464386293982206,6.765602905717491,177.0793601936548,192706815248,9391.94345703125,10167.2685546875,8790.3681640625,1.082552147082594,0.9359477305500192,1.0,0.0,83
2020-06-02,1743.0,1745.5,1721.800048828125,1725.199951171875,741,1728.7950073242187,1767.0532167795493,1690.536797868888,0.0,0.0,4.425997216933851,49.37123722848947,-0.7250602659809369,-0.3811119915787135,4.192611657898624,6315855,1728.7950073242187,1766.5999755859375,1695.300048828125,1.0218678143455726,0.9806252572721527,2.0,0.0,0.9968796807522003,97.83999633789062,97.91000366210938,97.43000030517578,97.66999816894531,0.0,99.41849975585937,101.03324855069715,97.80375096102159,0.0,1.0,3.2483869678240898,27.629018353821678,-0.15334443503054462,-2.786904566276482,-0.4436819917876278,0.0,99.41849975585937,100.47000122070312,97.66999816894531,1.0105765171213197,0.9824127140199477,0.0,3.0,10162.9736328125,10182.3408203125,9460.5712890625,9529.8037109375,39137252108,9404.93427734375,10083.69528594056,8726.17326874694,0.0,0.0,14.43414676978505,53.08100843630623,-6.269774820259899,4.9334259812441745,163.0153511907538,153569563140,9404.93427734375,10167.2685546875,8790.3681640625,1.0810568425959335,0.9346549273861782,1.0,0.0,84
2020-06-03,1726.300048828125,1726.300048828125,1684.5,1697.800048828125,2755,1728.2650085449218,1767.9073271042282,1688.6226899856154,0.0,0.0,4.587527764932588,41.13524545319616,-1.5882160398357326,-2.660239860262312,0.9554645311579861,6313100,1728.2650085449218,1766.5999755859375,1695.300048828125,1.0221811856697203,0.9809259809382179,2.0,0.0,0.9958939466215925,97.56999969482422,97.62999725341797,97.19000244140625,97.27999877929688,0.0,99.29699974060058,101.15334226536099,97.44065721584018,0.0,1.0,3.73897001844938,24.578943205178476,-0.39930316060192705,-3.107572409526135,-0.5209800545749346,0.0,99.29699974060058,100.47000122070312,97.27999877929688,1.011813060648024,0.9796871912890335,0.0,4.0,9533.7607421875,9682.859375,9471.8466796875,9656.7177734375,25007459262,9401.08408203125,10073.18226337727,8728.98590068523,0.0,0.0,14.298312311250024,55.11719747360992,1.3317594606312655,5.1634809850813985,160.7697854147391,178577022402,9401.08408203125,10167.2685546875,8790.3681640625,1.0814995872785242,0.9350377134551917,1.0,0.0,85
2020-06-04,1694.5,1718.9000244140625,1694.5,1718.9000244140625,807,1729.4450073242188,1766.4064291584664,1692.4835854899711,0.0,0.0,4.27436798252799,48.48786170798998,1.2427833065796756,-1.8108049590977984,0.3694277126362522,6313907,1729.4450073242188,1766.5999755859375,1697.800048828125,1.0214837523623863,0.9817022464651509,2.0,0.0,1.0050283431798006,97.31999969482422,97.62999725341797,96.56999969482422,96.68000030517578,0.0,99.12649993896484,101.26511989775663,96.98787998017305,0.0,1.0,4.314930841114344,20.677034934123128,-0.6167747549856939,-2.999897580715658,-0.6211273186474529,0.0,99.12649993896484,100.47000122070312,96.68000030517578,1.0135534017902934,0.9753194187700015,0.0,5.0,9655.8544921875,9887.6103515625,9525.2470703125,9800.63671875,25921805071,9424.7060546875,10117.778878639321,8731.633230735679,0.0,0.0,14.707574324975631,57.44418497397698,1.4903505382374727,6.421231115414021,168.78410583418736,204498827473,9424.7060546875,10167.2685546875,8790.3681640625,1.0787889294044006,0.9326941459028842,1.0,0.0,86
2020-06-05,1711.800048828125,1711.800048828125,1668.5999755859375,1676.199951171875,1502,1728.0350036621094,1770.458478647544,1685.6115286766747,0.0,1.0,4.910024958467795,37.855691814918615,-2.484151063802742,-2.574835735433014,-3.7677648053788744,6312405,1728.0350036621094,1766.5999755859375,1676.199951171875,1.0223172400108216,0.9700034707743861,2.0,1.0,0.9783458258338193,96.73999786376953,97.02999877929688,96.44000244140625,96.94000244140625,0.0,98.97900009155273,101.28686457789577,96.6711356052097,0.0,0.0,4.663341687041346,26.309633819663844,0.2689306324056284,-2.4454062976861137,-0.6619958474664998,0.0,98.97900009155273,100.47000122070312,96.68000030517578,1.0150638128064666,0.9767728529864876,0.0,5.0,9800.2158203125,9869.2373046875,9663.216796875,9665.533203125,23509628646,9439.13203125,10139.604824804943,8738.659237695056,0.0,0.0,14.84188993725055,54.49709362037243,-1.3785177382049874,9.95595432100809,160.0968420068657,180989198827,9439.13203125,10167.2685546875,8790.3681640625,1.0771401990169085,0.9312686945113549,1.0,0.0,87
2020-06-08,1679.0999755859375,1699.4000244140625,1675.9000244140625,1698.300048828125,587,1724.5800048828125,1771.9713199578066,1677.1886898078185,0.0,0.0,5.49598336300024,45.23691514894592,0.8132537956034636,-1.866400509272893,-6.427587886391166,6699870,1724.5800048828125,1766.5999755859375,1676.199951171875,1.0243653356667441,0.9719467617773841,2.0,1.0,0.967582096668952,96.83999633789062,97.06999969482422,96.5999984741211,96.62000274658203,0.0,98.82350006103516,101.3194347483122,96.32756537375812,0.0,0.0,5.05129789116052,23.980970127454796,-0.3301007703374492,-2.5221952489163018,-0.7084916437205067,0.0,98.82350006103516,100.47000122070312,96.62000274658203,1.0166610285878466,0.977702699124275,0.0,5.0,9760.0634765625,9782.306640625,9675.8857421875,9771.4892578125,21486346311,9442.015478515625,10147.925757892617,8736.105199138632,0.0,0.0,14.9525338310072,56.63730435728635,0.1294898011771073,6.431440465753792,146.53737928753617,207052376761,9442.015478515625,10167.2685546875,8790.3681640625,1.0768112568574069,0.9309842992806056,1.0,0.0,89
2020-06-09,1694.5999755859375,1720.9000244140625,1692.0,1714.699951171875,690,1722.645001220703,1768.299838587161,1676.990163854245,0.0,0.0,5.300550877761347,50.29684496763238,0.9656657759072873,0.5807075352065579,-5.184894152983134,6700560,1722.645001220703,1766.5999755859375,1676.199951171875,1.0255159794003332,0.9730385250496091,1.0,1.0,0.9867072752864592,96.62999725341797,97.05999755859375,96.2300033569336,96.31999969482422,0.0,98.62750015258788,101.25965434989487,95.9953459552809,0.0,0.0,5.337566486496663,21.95659685331256,-0.31049787127895856,-3.0693398082478383,-0.7566166464032307,0.0,98.62750015258788,100.47000122070312,96.31999969482422,1.018681413046713,0.9766038837627061,0.0,5.0,9774.3603515625,9836.369140625,9664.7197265625,9795.7001953125,23717842782,9455.651416015626,10177.64382981743,8733.65900221382,0.0,0.0,15.271130079497674,57.20259221317323,0.24777121338637187,2.833889101386261,144.4168386229412,230770219543,9455.651416015626,10167.2685546875,8790.3681640625,1.0752583938814162,0.9296417324747934,1.0,0.0,90
2020-06-10,1716.0999755859375,1740.800048828125,1711.9000244140625,1713.300048828125,718,1719.9800048828124,1761.0532690066689,1678.906740758956,0.0,0.0,4.776016466151292,49.859904767980964,-0.08164124241055726,0.17540781818111742,-4.296399961858697,6699842,1719.9800048828124,1755.199951171875,1676.199951171875,1.0204769510047078,0.9745461844982783,0.0,1.0,0.9931023054251382,96.43000030517578,96.45999908447266,95.72000122070312,95.95999908447266,0.0,98.42900009155274,101.2315770631376,95.62642311996787,0.0,0.0,5.694616360987272,19.73531823610692,-0.37375478767874837,-3.905469158864224,-0.8103089454515526,0.0,98.42900009155274,100.47000122070312,95.95999908447266,1.0207357702227187,0.9749159190402873,0.0,5.0,9794.119140625,9908.896484375,9728.291015625,9870.0947265625,25706567600,9495.06806640625,10217.184612860092,8772.951519952407,0.0,0.0,15.210350076556189,59.02626064087611,0.7594610876882513,4.565791296468747,146.78744821974578,256476787143,9495.06806640625,10167.2685546875,8790.3681640625,1.0707946992670343,0.9257825328459738,1.0,0.0,91
2020-06-11,1737.199951171875,1744.0999755859375,1720.0,1732.0,347,1719.9900024414062,1761.0748657700456,1678.9051391127668,0.0,0.0,4.777337457813389,55.58649992479587,1.0914580423122988,1.0914580423122922,-1.9452435550742848,6700189,1719.9900024414062,1755.199951171875,1676.199951171875,1.020471019413189,0.9745405198824562,0.0,1.0,1.0201436860574253,96.08999633789062,96.83000183105469,95.94999694824219,96.7300033569336,0.0,98.25350036621094,101.01983593188842,95.48716480053346,0.0,0.0,5.631016819485881,35.29276255640136,0.8024221340218185,-2.3027964146084603,-0.7693568324915816,0.0,98.25350036621094,100.47000122070312,95.95999908447266,1.0225590014221462,0.9766573071372527,0.0,5.0,9870.078125,9938.2978515625,9263.0693359375,9321.78125,30247143440,9502.028271484374,10214.582885692267,8789.473657276481,0.0,0.0,14.997947677050641,43.75691283881202,-5.555301055894358,-3.9032644386152975,98.52751279517724,226229643703,9502.028271484374,10167.2685546875,8790.3681640625,1.0700103456016348,0.9251044001250166,1.0,0.0,92
2020-06-12,1724.9000244140625,1743.0,1724.9000244140625,1729.300048828125,318,1719.2450073242187,1759.0678273282394,1679.422187320198,0.0,0.0,4.632593939126778,54.58634275382,-0.15588632632073107,-0.4375597604416712,-0.4048552592175838,6699871,1719.2450073242187,1755.199951171875,1676.199951171875,1.0209132169612145,0.9749628145092957,0.0,1.0,1.0060503951750235,96.80999755859375,97.44999694824219,96.48999786376953,97.31999969482422,0.0,98.09600028991699,100.69313271990679,95.49886785992719,0.0,0.0,5.295083229314398,44.45809478025772,0.609941401235714,-1.7565090921189723,-0.6746375017386015,0.0,98.09600028991699,100.4000015258789,95.95999908447266,1.0234872087460507,0.9782253996174003,0.0,5.0,9320.6904296875,9540.4658203125,9285.8515625,9480.84375,22610564515,9515.606103515625,10215.568193438901,8815.64401359235,0.0,0.0,14.711876097197186,48.085629713183764,1.7063530642279279,0.20912201371493597,74.86816643681595,248840208218,9515.606103515625,10167.2685546875,8790.3681640625,1.0684835463009668,0.9237843673263041,1.0,0.0,93
2020-06-15,1730.0,1730.0,1703.300048828125,1720.300048828125,188,1718.740008544922,1757.2131242929158,1680.266892796928,0.0,0.0,4.476897675823011,50.33148334765634,-1.171936744756974,-1.0070203422885746,1.5132129235328193,7016757,1718.740008544922,1755.199951171875,1676.199951171875,1.0212131808450888,0.9752492772836183,0.0,1.0,1.02119201814055,97.08999633789062,97.38999938964844,96.5999984741211,96.68000030517578,0.0,97.91000022888184,100.34845047860584,95.47154997915784,0.0,0.0,4.9810034603691005,37.97501913821022,-0.65762370700303,-1.727990440844544,-0.6482497624626546,0.0,97.91000022888184,99.86000061035156,95.95999908447266,1.0199162534665638,0.9800837387411836,0.0,5.0,9386.03515625,9504.8603515625,8990.17578125,9450.7021484375,26699704768,9604.626708984375,10041.449394793486,9167.804023175264,0.0,0.0,9.096088771477142,47.64548336099191,0.6808938469139436,-2.1333917986780375,20.682779273211054,238983857926,9604.626708984375,10167.2685546875,9181.017578125,1.0585802928891361,0.9558953050759254,1.0,0.0,95
2020-06-16,1726.300048828125,1729.5999755859375,1722.4000244140625,1729.5999755859375,22,1718.490008544922,1756.6110093355164,1680.3690077543274,0.0,0.0,4.436569383708234,53.48910034009187,0.5405991102626295,0.2550443159399407,2.1321290419427896,7016779,1718.490008544922,1755.199951171875,1676.199951171875,1.0213617434168478,0.9753911531851996,0.0,1.0,1.018430151244128,96.55999755859375,97.25,96.43000030517578,96.95999908447266,0.0,97.77450027465821,100.10550446922132,95.4434960800951,0.0,0.0,4.768122952334374,42.08072141944612,0.28961396194977507,-1.4032919511979407,-0.593248558774448,0.0,97.77450027465821,99.86000061035156,95.95999908447266,1.0213296956756104,0.9814419794006777,0.0,5.0,9454.2666015625,9579.4306640625,9400.4453125,9538.0244140625,21565537208,9622.47705078125,10015.589953160084,9229.364148402416,0.0,0.0,8.170721536756849,50.545320395979196,0.9239764861221245,-2.6795433013559786,19.010914205648078,260549395134,9622.47705078125,10167.2685546875,9321.78125,1.0566165552831346,0.9687506866273237,1.0,0.0,96
2020-06-17,1714.699951171875,1729.199951171875,1714.699951171875,1729.199951171875,51,1718.4200073242187,1756.4568501803303,1680.383164468107,0.0,0.0,4.426955307083451,53.3270721947313,-0.023128146375406278,1.849446427182235,2.518733595185722,7016728,1718.4200073242187,1755.199951171875,1676.199951171875,1.0214033494086971,0.9754308865280932,0.0,1.0,1.008456289970785,97.01000213623047,97.33999633789062,96.80000305175781,97.16000366210938,0.0,97.66400032043457,99.88911496586766,95.43888567500147,0.0,0.0,4.556673161313314,44.97172103331694,0.2062753501704151,-0.6747045949436503,-0.524944266053609,0.0,97.66400032043457,99.86000061035156,95.95999908447266,1.0224852584648585,0.9825524120415803,0.0,5.0,9533.7841796875,9540.4228515625,9327.33984375,9480.2548828125,20177709879,9620.20224609375,10016.044761997282,9224.359730190217,0.0,0.0,8.229401124373718,48.56789521770843,-0.6056760681470541,-1.9168970445686013,12.442415468090985,240371685255,9620.20224609375,10167.2685546875,9321.78125,1.0568664041149327,0.9689797585892831,1.0,0.0,97
2020-06-18,1730.5,1734.0999755859375,1717.300048828125,1724.800048828125,110,1719.4200073242187,1757.0210943629172,1681.81892028552,0.0,0.0,4.373694254868396,51.42336694960292,-0.254447285912085,0.3432441869953255,2.380363020938148,7016618,1719.4200073242187,1755.199951171875,1676.199951171875,1.0208093099389588,0.974863584250364,0.0,1.0,1.006712192652925,97.08000183105469,97.58000183105469,96.94999694824219,97.41999816894531,0.0,97.57900009155273,99.70271236648026,95.4552878166252,0.0,0.0,4.352805978612142,48.67221054594501,0.26759417150714615,-0.2559639650730421,-0.44278105715233096,0.0,97.57900009155273,99.86000061035156,95.95999908447266,1.0233759365914665,0.9834083050086488,0.0,5.0,9481.5673828125,9482.7822265625,9328.3955078125,9411.8408203125,17770083002,9618.8380859375,10017.346411912955,9220.329759962044,0.0,0.0,8.28599717377642,46.19011256924195,-0.7216479234543938,-2.5051470011030443,1.441271762487304,222601602253,9618.8380859375,10167.2685546875,9321.78125,1.0570162907255702,0.9691171809647374,1.0,0.0,98
2020-06-19,1723.699951171875,1750.699951171875,1723.5,1745.9000244140625,1329,1721.2000061035155,1760.248331244246,1682.1516809627851,0.0,0.0,4.537337323060872,59.18672801946465,1.2233287910835555,4.158219500809457,4.0635521613651235,7017947,1721.2000061035155,1755.199951171875,1676.199951171875,1.0197536282522617,0.973855417864242,0.0,1.0,1.008025418252923,97.41999816894531,97.72000122070312,97.16000366210938,97.62000274658203,0.0,97.49150009155274,99.45066495652897,95.5323352265765,0.0,0.0,4.019150106699373,51.462102969614726,0.20530135639078573,0.3495106615456865,-0.3569753233710742,0.0,97.49150009155274,99.86000061035156,95.95999908447266,1.0242944309665418,0.9842909278691796,0.0,5.0,9410.2939453125,9440.8759765625,9274.2958984375,9288.0185546875,19632223107,9598.218310546876,10019.722248587777,9176.714372505974,0.0,0.0,8.78296209574099,42.050107805157964,-1.3156009327927487,-4.824685919685302,-17.44793158473476,202969379146,9598.218310546876,10167.2685546875,9288.0185546875,1.0592870703425583,0.9676815273602897,1.0,0.0,99
2020-06-22,1755.199951171875,1767.5999755859375,1750.5,1756.699951171875,1356,1724.6,1769.2499608500773,1679.9500391499225,0.0,0.0,5.178007752531298,61.48372037022707,-0.2724978046054538,3.438727001394576,7.930236994095139,7795946,1724.6,1761.5,1676.199951171875,1.0213962658007654,0.9719354929675722,0.0,1.0,1.009191704744536,97.66000366210938,97.73999786376953,97.01000213623047,97.04000091552734,0.0,97.35050010681152,98.9868418636122,95.71415835001085,0.0,0.0,3.361753159984397,43.79236967269151,-0.5941424039500931,0.37236306290360016,-0.3374920110378241,0.0,97.35050010681152,99.05999755859375,95.95999908447266,1.0175602328689282,0.9857165497782422,0.0,5.0,9300.9150390625,9655.0732421875,9296.8720703125,9648.7177734375,21104009513,9554.54619140625,9918.660080382717,9190.432302429785,0.0,0.0,7.621793472597684,56.896424985508354,3.709174751916078,-2.242906063801273,-12.964120210182955,225879629048,9554.54619140625,9870.0947265625,9288.0185546875,1.0330260096957893,0.9721046262816253,0.0,0.0,101
2020-06-23,1755.4000244140625,1776.300048828125,1754.199951171875,1772.0999755859375,666,1725.445001220703,1772.9291146635187,1677.9608877778874,0.0,0.0,5.503984584756051,66.09598852026404,0.8766451210856729,3.3475258674168438,10.118500162089276,7796612,1725.445001220703,1772.0999755859375,1676.199951171875,1.0270393865537455,0.9714595075392212,0.0,1.0,1.0301109837165319,96.93000030517578,97.25,96.38999938964844,96.69000244140625,0.0,97.23450012207032,98.70427983185057,95.76472041229006,0.0,0.0,3.0231650451949905,39.81385270015342,-0.3606744340674206,-0.2578914727706019,-0.3475281799957628,0.0,97.23450012207032,99.05999755859375,95.95999908447266,1.0187741741278216,0.9868925017766572,0.0,5.0,9644.076171875,9670.541015625,9547.2470703125,9629.658203125,17006433272,9553.193212890625,9915.977113261142,9190.409312520107,0.0,0.0,7.5950290606704,56.05682916205974,-0.19753474772544743,3.302769555174876,3.1003322970773297,208873195776,9553.193212890625,9870.0947265625,9288.0185546875,1.0331723128183217,0.9722423013652325,0.0,0.0,102
2020-06-24,1778.300048828125,1783.0999755859375,1764.5,1765.800048828125,961,1726.8450012207031,1777.2640210708878,1676.4259813705185,0.0,0.0,5.839437797201668,62.68406750535513,-0.3555062832010569,3.0642618632917986,11.017722958290278,7795651,1726.8450012207031,1772.0999755859375,1676.199951171875,1.0262067379140825,0.9706719190124028,0.0,1.0,1.0209297373688526,96.66000366210938,97.23999786376953,96.55000305175781,97.1500015258789,0.0,97.13900032043458,98.34677156170206,95.9312290791671,0.0,0.0,2.486686577550475,46.863451723317795,0.4757462745452079,0.5485393958091395,-0.3091129872787519,0.0,97.13900032043458,98.37999725341797,95.95999908447266,1.0127754756471623,0.9878627406904259,0.0,5.0,9632.1494140625,9680.3671875,9278.2333984375,9313.6103515625,18961716075,9528.84189453125,9887.275351835007,9170.408437227492,0.0,0.0,7.523127390947019,44.07387813071391,-3.282025643027875,-1.7639083909330326,-12.424936021956455,189911479701,9528.84189453125,9870.0947265625,9288.0185546875,1.0358126240112244,0.9747269035933988,0.0,0.0,103
2020-06-25,1761.699951171875,1764.800048828125,1759.800048828125,1762.0999755859375,207,1728.6900024414062,1781.3825336977595,1675.997471185053,0.0,0.0,6.0962383286692585,60.64127388193361,-0.20954089590399239,1.7378738790956985,11.17224564865137,7795444,1728.6900024414062,1772.0999755859375,1676.199951171875,1.0251114850454528,0.9696359375044685,0.0,1.0,1.0190261539110999,97.23999786376953,97.5999984741211,97.16000366210938,97.43000030517578,0.0,97.09150047302246,98.16788699742024,96.01511394862469,0.0,0.0,2.217262106680198,50.76384719592907,0.2882128408637108,1.152409275195636,-0.25108084230187444,0.0,97.09150047302246,98.33999633789062,95.95999908447266,1.0128589614825765,0.9883460304657233,0.0,4.0,9314.126953125,9340.1611328125,9095.32421875,9264.8134765625,18616048626,9508.805908203125,9879.04107489068,9138.57074151557,0.0,0.0,7.787206306696357,42.51478554136087,-0.5239308190707503,-2.2211895182817454,-27.927354370298417,171295431075,9508.805908203125,9870.0947265625,9264.8134765625,1.03799518276503,0.9743403710207045,0.0,0.0,104
2020-06-26,1766.0,1772.5,1764.699951171875,1772.5,640,1732.425,1786.4039528753722,1678.4460471246277,0.0,0.0,6.231606317776784,64.27704267102862,0.5902062628770022,2.498117732729483,11.993608790376129,7796084,1732.425,1772.5,1676.199951171875,1.0231323145302105,0.9675454644050248,0.0,1.0,1.0276553512416025,97.3499984741211,97.68000030517578,97.26000213623047,97.5,0.0,97.04950065612793,97.98394059492445,96.11506071733142,0.0,0.0,1.925697571814374,51.747701543038325,0.0718461404136006,1.6048363174448304,-0.19771368188310134,0.0,97.04950065612793,97.81999969482422,95.95999908447266,1.007939237538443,0.9887737539679295,0.0,4.0,9260.9951171875,9310.5166015625,9101.73828125,9162.91796875,18341465836,9484.267822265625,9877.199901577724,9091.335742953526,0.0,0.0,8.285976032638736,39.290052494723554,-1.0998117562784016,-2.384949091616156,-47.741701886901865,152953965239,9484.267822265625,9870.0947265625,9162.91796875,1.0406807263910338,0.9661175897246161,0.0,0.0,105
2020-06-29,1779.800048828125,1780.199951171875,1774.300048828125,1774.800048828125,584,1740.6750061035157,1794.4423181525383,1686.907694054493,0.0,0.0,6.17775424596694,61.95065336533561,-0.5881364315702742,3.168051994018463,13.476017321977452,8296145,1740.6750061035157,1785.300048828125,1684.5999755859375,1.0256366309438212,0.9677854680965968,0.0,0.0,1.0075504109157678,97.5,97.6500015258789,97.11000061035156,97.54000091552734,0.0,97.03550071716309,97.93092148597614,96.14007994835004,0.0,0.0,1.845552941336401,52.35223522856856,0.04102658002804738,0.8373798516318252,-0.15132122530435765,0.0,97.03550071716309,97.66999816894531,95.95999908447266,1.006538817722306,0.9889164107492444,0.0,3.0,9140.029296875,9237.5732421875,9041.8759765625,9190.8544921875,16460547078,9386.957080078126,9767.08306600662,9006.831094149631,0.0,0.0,8.099024693214659,43.00414105070335,0.5170015512075743,-3.0526646614710407,-80.2659187242225,166702289933,9386.957080078126,9870.0947265625,9045.390625,1.0514690375552833,0.9636126540087171,0.0,0.0,107
2020-06-30,1777.300048828125,1793.199951171875,1774.4000244140625,1793.0,986,1746.0950073242188,1797.9806255607907,1694.209389087647,0.0,0.0,5.943046399987517,67.71702535719476,1.025464878924942,3.6655888823416776,14.79905353960089,8297131,1746.0950073242188,1793.0,1698.300048828125,1.0268627952539995,0.9726275155157011,0.0,0.0,1.020663772890703,97.4000015258789,97.80000305175781,97.2300033569336,97.38999938964844,0.0,97.02150077819825,97.8849883684697,96.15801318792678,0.0,0.0,1.7799922354231321,49.754936446475305,-0.15378462627738676,0.07192734796930086,-0.12734562158745177,0.0,97.02150077819825,97.62000274658203,95.95999908447266,1.0061687560343149,0.9890591087005313,0.0,2.0,9185.5810546875,9217.8359375,9084.837890625,9137.9931640625,15735797743,9350.352001953124,9674.154792869807,9026.549211036441,0.0,0.0,6.926002162251141,41.01357606628817,-0.5751513982724221,-2.9096078171975233,-83.80298162038889,150966492190,9350.352001953124,9648.7177734375,9045.390625,1.0319095763904986,0.9673850378157504,0.0,0.0,108
2020-07-01,1793.5999755859375,1798.0,1765.800048828125,1773.199951171875,331,1749.8400024414063,1798.06946864982,1701.6105362329927,0.0,0.0,5.512442982343884,57.23244035145853,-1.104297201791693,2.5445293339374255,13.807893377231721,8296800,1749.8400024414063,1793.0,1713.300048828125,1.024665110809203,0.9791181173351277,0.0,0.0,1.0006207186959493,97.38999938964844,97.62000274658203,97.02999877929688,97.19999694824219,0.0,97.0175006866455,97.87689276762646,96.15810860566455,0.0,0.0,1.771622799801209,46.507569809240024,-0.1950944066095195,0.5378533734226396,-0.12384275624624763,0.0,97.0175006866455,97.62000274658203,95.95999908447266,1.0062102409943803,0.989099888219256,0.0,1.0,9145.9853515625,9309.7548828125,9104.7353515625,9228.3251953125,15971550355,9345.67919921875,9673.66663464609,9017.69176379141,0.0,0.0,7.019017632335546,45.778932020044586,0.988532488788163,-0.6426920771478628,-77.1492379137344,166938042545,9345.67919921875,9648.7177734375,9045.390625,1.0324255271081937,0.9678687265186834,0.0,0.0,109
2020-07-02,1773.4000244140625,1784.0,1768.699951171875,1784.0,215,1753.3050048828125,1800.891482889367,1705.718526876258,0.0,0.0,5.428203064957889,60.90131189796545,0.6090711214483902,3.4322790756005035,13.770148854670879,8297015,1753.3050048828125,1793.0,1713.300048828125,1.0226400968494587,0.9771831164895572,0.0,0.0,1.010306915091521,97.1500015258789,97.33999633789062,96.80999755859375,97.31999969482422,0.0,97.04950065612793,97.90388849847861,96.19511281377726,0.0,0.0,1.7607258905493965,48.85032816600982,0.12345961970134933,0.37128776170668676,-0.10871541455807687,0.0,97.04950065612793,97.62000274658203,95.95999908447266,1.0058784649750598,0.9887737539679295,0.0,0.0,9231.1396484375,9274.962890625,9036.623046875,9123.41015625,16338916796,9327.80751953125,9663.25495862367,8992.360080438832,0.0,0.0,7.192417690653119,41.45684967880058,-1.1368806022981404,-2.2387809027264374,-79.97137495164498,150599125749,9327.80751953125,9648.7177734375,9045.390625,1.034403610198249,0.9697231215438457,0.0,0.0,110
2020-07-06,1788.199951171875,1790.0999755859375,1788.199951171875,1788.5,172,1759.820001220703,1806.2956913905475,1713.3443110508586,0.0,0.0,5.281868615836451,62.44441896594065,0.07834057597160271,1.532784558614817,13.656384255473768,8439965,1759.820001220703,1793.0,1720.300048828125,1.0188542002910987,0.9775431848909747,0.0,0.0,1.0090267983074752,97.1500015258789,97.19999694824219,96.56999969482422,96.79000091552734,0.0,97.04200057983398,97.90271169969238,96.18128945997559,0.0,0.0,1.7738940143764008,40.20868693949058,-0.5445938974094178,-0.3808179627789841,-0.14152207472703537,0.0,97.04200057983398,97.62000274658203,95.95999908447266,1.0059562062127165,0.9888501732353385,0.0,0.0,9072.849609375,9375.474609375,9058.6640625,9375.474609375,17889263251,9268.728369140625,9606.665954741256,8930.790783539993,0.0,0.0,7.291994589587149,55.86898460107138,3.32305643833104,0.6642349795331659,-56.844880893106165,154796540374,9268.728369140625,9648.7177734375,9045.390625,1.0409969295855097,0.9759041655720317,0.0,0.0,112
2020-07-07,1789.300048828125,1804.199951171875,1783.300048828125,1804.199951171875,751,1763.5649963378905,1811.6431859437505,1715.4868067320306,0.0,0.0,5.452386467830348,67.74446499073849,0.8778278541724971,2.7039335868549026,14.693508987506448,8440716,1763.5649963378905,1804.199951171875,1720.300048828125,1.0230413706998973,0.9754673359929422,0.0,0.0,1.0105864010680758,96.75,97.1500015258789,96.5999984741211,96.87999725341797,0.0,97.05500030517578,97.89748486984871,96.21251574050285,0.0,0.0,1.7360971861807337,42.13983629350221,0.09298102803942943,-0.5543019150861372,-0.15556503503945862,0.0,97.05500030517578,97.62000274658203,95.95999908447266,1.0058214665872927,0.9887177248234501,0.0,0.0,9349.1611328125,9360.6171875,9201.8154296875,9252.27734375,13839652594,9257.3294921875,9581.03847913173,8933.62050524327,0.0,0.0,6.9935716821447516,49.90876423288918,-1.314037643510968,-0.13530906849029464,-47.11762753327639,140956887780,9257.3294921875,9648.7177734375,9045.390625,1.0422787458932192,0.9771058308590657,0.0,0.0,113
2020-07-08,1801.5,1817.9000244140625,1801.5,1815.5,209,1767.304998779297,1819.174534209239,1715.435463349355,0.0,0.0,5.869901965508964,71.01567113395022,0.6263190962168652,2.4490731342464165,16.185176822095173,8440925,1767.304998779297,1815.5,1720.300048828125,1.0272703360506488,0.973403034573184,0.0,0.0,1.0229321332274859,96.98999786376953,97.05000305175781,96.4000015258789,96.43000030517578,0.0,97.06050033569336,97.88496322808206,96.23603744330467,0.0,0.0,1.6988638829126335,35.72867248081842,-0.4644890183729933,-1.2190149640698669,-0.2022274810918674,0.0,97.06050033569336,97.62000274658203,95.95999908447266,1.0057644707059368,0.9886616981427614,0.0,0.0,9253.0205078125,9450.3359375,9249.5,9428.3330078125,19702359882,9258.1541015625,9583.513101243478,8932.795101881524,0.0,0.0,7.028593305139866,57.16479066664648,1.9028359994139876,2.8966213597861965,-23.858129195985384,160659247662,9258.1541015625,9648.7177734375,9045.390625,1.0421859117476866,0.97701880156363,0.0,0.0,114
2020-07-09,1816.0999755859375,1819.800048828125,1799.199951171875,1799.199951171875,396,1771.2499938964843,1820.1351787019244,1722.3648090910442,0.0,0.0,5.5198515143421405,61.08646094723417,-0.8978269803428862,1.8914883576946258,15.597876024969082,8440529,1771.2499938964843,1815.5,1724.800048828125,1.0249823606244155,0.9737756131385066,0.0,0.0,1.0034578645688093,96.44999694824219,96.80999755859375,96.23999786376953,96.69999694824219,0.0,97.09750022888184,97.77428308196485,96.42071737579883,0.0,0.0,1.3940273467137132,41.64717952246851,0.2799923698143081,-0.3503750660319216,-0.20989170398912904,0.0,97.09750022888184,97.62000274658203,96.43000030517578,1.0053812149279695,0.9931254674720502,0.0,0.0,9427.994140625,9431.37890625,9234.9990234375,9277.9677734375,18000702524,9257.6515625,9582.855510351053,8932.447614648945,0.0,0.0,7.025625141658148,50.2563087979529,-1.5948231171979632,2.5712228258522556,-19.245566230787517,142658545138,9257.6515625,9648.7177734375,9045.390625,1.0422424853967927,0.9770718377045206,0.0,0.0,115
2020-07-10,1805.5,1805.5,1797.699951171875,1798.199951171875,236,1774.6799926757812,1820.951117163235,1728.4088681883275,0.0,0.0,5.214587945817579,60.50975492358188,-0.055580259400778154,2.0486905445835135,14.80644771151242,8440293,1774.6799926757812,1815.5,1724.800048828125,1.023001334039199,0.9718935559912131,0.0,0.0,1.01409880480962,96.75,96.97000122070312,96.44000244140625,96.6500015258789,0.0,97.0935001373291,97.77980273455351,96.40719754010469,0.0,0.0,1.413694214862385,40.87279160703717,-0.051701575947349365,-0.04137027046988043,-0.2162593392564105,0.0,97.0935001373291,97.62000274658203,96.43000030517578,1.0054226349705,0.9931663825980641,0.0,0.0,9273.357421875,9287.4716796875,9118.001953125,9278.8076171875,16860035604,9254.97490234375,9578.552973824213,8931.396830863288,0.0,0.0,6.992521857590747,50.29358871722236,0.009052022711308894,1.4789125910976662,-15.425101265540434,159518580742,9254.97490234375,9648.7177734375,9045.390625,1.0425439155965768,0.977354419698029,0.0,0.0,116
2020-07-13,1805.0,1811.0,1805.0,1811.0,164,1782.7549926757813,1820.3126952201935,1745.197290131369,0.0,0.0,4.213445223680561,65.41543248203627,0.3602105846494785,1.4395311975006388,14.601472881065092,8722865,1782.7549926757813,1815.5,1745.9000244140625,1.018367643034936,0.9793269583239802,0.0,0.0,1.013373635913249,96.66000366210938,96.68000030517578,96.2699966430664,96.55999755859375,0.0,97.05550003051758,97.77097177201446,96.3400282890207,0.0,0.0,1.4743558917772108,39.40712033935377,-0.09312360668826125,-0.6073123602864694,-0.22502084410223233,0.0,97.05550003051758,97.62000274658203,96.43000030517578,1.005816287751719,0.9935552366929734,0.0,0.0,9277.205078125,9306.4052734375,9224.29296875,9243.6142578125,17519821266,9213.89765625,9410.257064584612,9017.538247915387,0.0,0.0,4.262244180700604,48.53837993868646,-0.3545059255915528,0.16567537637020024,-12.674970883268543,143201210938,9213.89765625,9428.3330078125,9045.390625,1.023273033797705,0.9817116450022975,0.0,0.0,118
2020-07-14,1791.0,1811.5,1791.0,1810.5999755859375,339,1785.989990234375,1821.3754542151828,1750.6045262535672,0.0,0.0,3.96256016823075,65.11998837857027,-0.022088592714664124,2.0171245082763365,14.381968262405053,8722526,1785.989990234375,1815.5,1756.699951171875,1.0165230543995112,0.9836001101783016,0.0,0.0,1.0123567098607422,96.54000091552734,96.69999694824219,96.18000030517578,96.26000213623047,0.0,97.03450012207031,97.8145637088875,96.25443653525312,0.0,0.0,1.607806678729452,34.78722135933319,-0.3106829224816865,-1.2008602743308814,-0.25358379821257415,0.0,97.03450012207031,97.62000274658203,96.26000213623047,1.0060339634230624,0.9920183235357989,0.0,0.0,9238.703125,9283.841796875,9171.6611328125,9243.2138671875,18085038362,9210.37783203125,9401.926322797544,9018.829341264956,0.0,0.0,4.159405710808935,48.514753431655485,-0.004331537576462985,1.3131461688744572,-12.669840162177934,125116172576,9210.37783203125,9428.3330078125,9045.390625,1.0236640862900608,0.9820868144564636,0.0,0.0,119
2020-07-15,1806.0999755859375,1813.5,1806.0999755859375,1811.4000244140625,167,1788.4849914550782,1823.6476560275823,1753.322326882574,0.0,0.0,3.9321173776131535,65.4665832606462,0.044186945703783564,1.0262144123849692,14.039707715747,8722693,1788.4849914550782,1815.5,1756.699951171875,1.015104967989104,0.982227952465319,0.0,0.0,1.003990729097133,96.16999816894531,96.25,95.77999877929688,96.08000183105469,0.0,96.99050025939941,97.87472792488359,96.10627259391524,0.0,1.0,1.8233283942640237,32.26541821478685,-0.18699387199372364,-1.4564083784054487,-0.28592118376901965,0.0,96.99050025939941,97.62000274658203,96.08000183105469,1.0064903519983817,0.9906124988951536,0.0,1.0,9241.8974609375,9275.3251953125,9171.93359375,9192.8369140625,15844731575,9206.77900390625,9396.799810506165,9016.758197306333,0.0,0.0,4.127845504259284,45.423728486772085,-0.5450155524782674,1.161325806663422,-16.808291887478845,109271441001,9206.77900390625,9428.3330078125,9045.390625,1.024064225264042,0.9824707013345519,0.0,0.0,120
2020-07-16,1810.9000244140625,1810.9000244140625,1794.300048828125,1798.699951171875,146,1790.5849914550781,1822.7965468829152,1758.373436027241,0.0,0.0,3.5978806458844605,55.70372497669673,-0.7011191934976124,1.4380780905812411,12.44366074957702,8722547,1790.5849914550781,1815.5,1762.0999755859375,1.0139144517930283,0.9840917822917788,0.0,0.0,0.9907463239723905,96.0,96.4000015258789,95.88999938964844,96.3499984741211,0.0,96.95,97.8728216008768,96.0271783991232,0.0,0.0,1.9037062421388375,39.566868819499966,0.2810123209002091,-1.2200147941733452,-0.2815318994995266,0.0,96.95,97.62000274658203,96.08000183105469,1.0069108070818156,0.9910263211042257,0.0,1.0,9191.98046875,9214.3125,9088.947265625,9132.2275390625,15713967522,9205.244482421875,9397.143711230156,9013.345253613594,0.0,0.0,4.1693456197655,41.8585728208275,-0.6593108913667822,-0.0028551056346311694,-24.82833334841598,93557473479,9205.244482421875,9428.3330078125,9045.390625,1.0242349375746218,0.9826344799720281,0.0,0.0,121
2020-07-17,1798.5,1810.0999755859375,1798.5,1808.300048828125,24,1792.3949951171876,1824.3152917834598,1760.4746984509154,0.0,0.0,3.561748024651811,60.63434674159823,0.5337242406658893,1.3621103603209082,11.877874078198829,8722571,1792.3949951171876,1815.5,1762.0999755859375,1.0128905765446539,0.9830980226937817,0.0,0.0,1.0050578578830678,96.27999877929688,96.33000183105469,95.9000015258789,95.94000244140625,0.0,96.87600021362304,97.87075404820733,95.88124637903876,0.0,0.0,2.053664132273705,33.47799566233833,-0.42552780405592516,-1.4888561015807003,-0.30890516982947247,0.0,96.87600021362304,97.62000274658203,95.94000244140625,1.0076799468528672,0.9903381872687476,0.0,1.0,9131.8125,9182.25390625,9089.2021484375,9151.392578125,13944570749,9210.544580078125,9389.938850469627,9031.150309686624,0.0,0.0,3.8954107182656976,43.41882596477857,0.2098616025556055,0.8535451520962165,-28.676008565629672,107502044228,9210.544580078125,9428.3330078125,9073.9423828125,1.0236455538367881,0.9851689337065814,0.0,0.0,122
2020-07-20,1807.0,1817.300048828125,1807.0,1815.9000244140625,89,1797.3099975585938,1825.092652904889,1769.5273422122984,0.0,0.0,3.091581906742226,64.404815503003,0.30933963624220073,1.532011429357702,11.379398538865416,8978726,1797.3099975585938,1815.9000244140625,1772.5,1.0103432501241971,0.9861960387510809,0.0,0.0,1.006317553014166,96.01000213623047,96.18000030517578,95.7300033569336,95.83000183105469,0.0,96.78650016784668,97.81878342747144,95.75421690822192,0.0,0.0,2.1331141385101877,32.00955044293339,-0.11465562596659762,-1.409460041358855,-0.3333433549123015,0.0,96.78650016784668,97.54000091552734,95.83000183105469,1.0077851843632526,0.9901174406024266,0.0,1.0,9187.220703125,9214.2705078125,9137.509765625,9164.2314453125,13755604145,9212.3775390625,9389.079544983666,9035.675533141333,0.0,0.0,3.836186807844362,44.77572660312171,-0.23499201650132306,-2.80114801080064,-28.96329468320073,118938044341,9212.3775390625,9428.3330078125,9073.9423828125,1.0234418821671498,0.9849729176140465,0.0,0.0,124
2020-07-21,1822.0,1842.4000244140625,1822.0,1842.4000244140625,117,1800.804998779297,1832.5308669715794,1769.0791305870146,1.0,0.0,3.5235206714539626,74.2271285163496,1.4593314413633873,2.117286014633553,13.441837162544516,8978843,1800.804998779297,1842.4000244140625,1773.199951171875,1.0230980176437545,0.984670718025475,1.0,0.0,1.017338500504728,95.75,95.91999816894531,95.05000305175781,95.12000274658203,0.0,96.69050025939941,97.94402927925312,95.43697123954571,0.0,1.0,2.592869033650168,24.34980988322492,-0.7408943659673151,-2.260580512886284,-0.4071335623537209,0.0,96.69050025939941,97.54000091552734,95.12000274658203,1.0087857716512885,0.9837574786705614,0.0,2.0,9162.5146484375,9407.2626953125,9149.3896484375,9374.8876953125,18069581955,9219.7056640625,9410.07330275513,9029.338025369869,0.0,0.0,4.129581694449641,60.80151128599056,2.298678850016933,1.0446244721012976,-10.364613328634732,137007626296,9219.7056640625,9428.3330078125,9073.9423828125,1.0226284169312703,0.984190028775195,0.0,0.0,125
2020-07-22,1858.0999755859375,1867.0,1854.699951171875,1864.0999755859375,213,1804.7449951171875,1845.9470163197534,1763.5429739146216,1.0,0.0,4.565965974588064,79.39931862992484,1.1778088842989476,2.6769471542791243,16.614602008589372,8979056,1804.7449951171875,1864.0999755859375,1773.199951171875,1.0328882920464317,0.9825210519875889,2.0,0.0,1.0295482164594012,95.12999725341797,95.41000366210938,94.83000183105469,94.97000122070312,0.0,96.60450019836426,98.06524463203142,95.1437557646971,0.0,1.0,3.0241747137404946,23.054748783928417,-0.15769714208119234,-1.8803592081919784,-0.46769469543008313,0.0,96.60450019836426,97.54000091552734,94.97000122070312,1.009683821304827,0.9830805089379385,0.0,3.0,9375.080078125,9530.5185546875,9319.6533203125,9525.36328125,16532254884,9239.8033203125,9466.6401020266,9012.966538598399,1.0,0.0,4.909991562600248,68.13969261792028,1.6050921443329758,2.6571912495070515,16.61090478259939,153539881180,9239.8033203125,9525.36328125,9073.9423828125,1.0309054155200181,0.9820492999958802,1.0,0.0,126
2020-07-23,1868.699951171875,1890.300048828125,1868.5,1889.0999755859375,133,1810.4599914550781,1863.4767284626869,1757.4432544474694,1.0,0.0,5.856714565119869,83.60982250196976,1.34112978528107,4.996666677069872,20.840075517850664,8979189,1810.4599914550781,1889.0999755859375,1773.199951171875,1.0434364661478412,0.9794195726726571,3.0,0.0,1.042894970809669,94.9800033569336,95.18000030517578,94.58999633789062,94.69000244140625,0.0,96.48150024414062,98.13884883093489,94.82415165734635,0.0,1.0,3.4355779762969068,20.764255610635658,-0.29482865715266815,-2.260523197872464,-0.5286693731802075,0.0,96.48150024414062,97.54000091552734,94.69000244140625,1.010971022099659,0.9814316962505653,0.0,4.0,9527.1416015625,9610.2470703125,9483.00390625,9581.072265625,18146399001,9264.491748046876,9524.60427007814,9004.379226015611,1.0,0.0,5.615257244653506,70.41776143606943,0.584848921034431,3.68736799330805,41.11544878861969,171686280181,9264.491748046876,9581.072265625,9073.9423828125,1.0341713853482426,0.9794322915475048,2.0,0.0,127
2020-07-24,1884.300048828125,1897.300048828125,1884.300048828125,1897.300048828125,474,1815.6749938964845,1880.089730204778,1751.2602575881908,1.0,0.0,7.095403805728247,84.74606149881107,0.4340730161538575,5.511072202602782,24.317119383028057,8979663,1815.6749938964845,1897.300048828125,1773.199951171875,1.04495576312172,0.9766064725970274,4.0,0.0,1.0548174238799588,94.7699966430664,94.83000183105469,94.33000183105469,94.44000244140625,0.0,96.33200035095214,98.15161999484826,94.51238070705602,0.0,1.0,3.777809320406442,18.901303369669634,-0.2640194250229322,-2.063670908920157,-0.5862970459185135,0.0,96.33200035095214,97.54000091552734,94.44000244140625,1.012539971766124,0.9803596115241762,0.0,5.0,9585.5146484375,9623.3369140625,9481.4541015625,9536.892578125,16552768324,9284.711962890626,9562.881974143327,9006.541951637924,0.0,0.0,5.992000879822626,66.24408413525308,-0.4611142289210002,2.807013185199159,54.7181391776885,155133511857,9284.711962890626,9581.072265625,9073.9423828125,1.0319191703435577,0.9772992871593071,2.0,0.0,128
2020-07-27,1901.699951171875,1938.0,1901.5,1931.0,364,1829.8749938964843,1914.8936757919664,1744.8563120010022,1.0,0.0,9.292293974075873,88.60173692447428,1.088893799592272,6.6261733848702375,31.330447979770042,10454130,1829.8749938964843,1931.0,1787.0999755859375,1.0552633411794885,0.9766240762602789,6.0,0.0,1.066674003157658,94.3499984741211,94.41999816894531,93.4800033569336,93.68000030517578,0.0,96.14100036621093,98.21437150623687,94.06762922618499,0.0,1.0,4.313188196769864,14.505406043748991,-0.8047459938409052,-3.123057640511439,-0.6846052129279911,0.0,96.14100036621093,97.54000091552734,93.68000030517578,1.0145515497445157,0.9744021795939198,0.0,6.0,9905.2177734375,11298.2216796875,9903.9697265625,10990.873046875,35359749590,9428.284912109375,10249.362757990632,8607.207066228118,1.0,0.0,17.41733207121672,90.58346626983212,10.96100707382146,19.5590996514036,227.5363999446945,227611331375,9428.284912109375,10990.873046875,9132.2275390625,1.1657340809417722,0.968599021369557,5.0,0.0,130
2020-07-28,1931.5,1944.699951171875,1928.5999755859375,1944.699951171875,825,1837.7549926757813,1933.9361367351232,1741.5738486164394,1.0,0.0,10.467243396716519,89.81131676207482,0.7094744263011377,7.406383375352732,34.74531909090683,10454955,1837.7549926757813,1944.699951171875,1788.5,1.0581932623893358,0.973198281124479,7.0,0.0,1.070928974627539,93.58000183105469,94.01000213623047,93.48999786376953,93.76000213623047,0.0,95.95200042724609,98.16522747918046,93.73877337531172,0.0,0.0,4.613196269133561,16.76943123356878,0.08539905080493515,-2.990170040374613,-0.738597589922847,0.0,95.95200042724609,97.38999938964844,93.68000030517578,1.014986649116218,0.9763214929136051,0.0,6.0,11017.4638671875,11204.3271484375,10632.6318359375,10912.8232421875,28766551141,9502.509423828125,10547.929208732281,8457.08963892397,1.0,0.0,22.00302548046312,86.72256172414326,-0.7101328925793737,19.497934052876143,303.73570779545116,198844780234,9502.509423828125,10990.873046875,9132.2275390625,1.1566284816634553,0.9610332525598848,6.0,0.0,131
2020-07-29,1953.199951171875,1953.5,1952.5999755859375,1953.5,209835,1846.0049926757813,1951.7061419408785,1740.303843410684,1.0,0.0,11.451881190406056,90.5286658870761,0.4525144777641543,7.844759504842277,37.43346913507685,10664790,1846.0049926757813,1953.5,1798.199951171875,1.0582311574187049,0.9741035145118362,8.0,0.0,1.0603017662362821,93.75,93.80000305175781,93.18000030517578,93.26000213623047,0.0,95.7455005645752,98.14625210667069,93.3447490224797,0.0,1.0,5.014860286779354,14.16462587580098,-0.5332764383617628,-3.4175595544736885,-0.8090664475264333,0.0,95.7455005645752,97.31999969482422,93.26000213623047,1.0164446279038157,0.9740405719988022,0.0,7.0,10912.953125,11304.3974609375,10856.1416015625,11100.4677734375,24617249714,9593.634423828125,10842.753253657493,8344.515593998758,1.0,0.0,26.040575962054103,88.07976957036526,1.7194865809297744,21.29812680062994,371.1297746192504,223462029948,9593.634423828125,11100.4677734375,9132.2275390625,1.1570659546779047,0.9519048918916893,7.0,0.0,132
2020-07-30,1963.4000244140625,1965.0999755859375,1930.0,1942.300048828125,28853,1852.9099975585937,1964.6553860767947,1741.1646090403926,0.0,0.0,12.061609971929288,82.33144242091453,-0.5733274211351391,7.983549316421162,37.805507046657794,10635937,1852.9099975585937,1953.5,1798.199951171875,1.0542875814658803,0.9704734463849809,8.0,0.0,1.0419505789745034,93.31999969482422,93.68000030517578,92.93000030517578,92.93000030517578,0.0,95.53200073242188,98.12884028265819,92.93516118218557,0.0,1.0,5.436585710184941,12.71613456452721,-0.3538514084233335,-3.4593826689739258,-0.8757934842415978,0.0,95.53200073242188,97.31999969482422,92.93000030517578,1.0187162306734305,0.9727630489543069,0.0,8.0,11099.8330078125,11169.3564453125,10895.455078125,11111.2138671875,22857247900,9685.254736328125,11087.933250503553,8282.576222152697,1.0,0.0,28.965237412169742,88.15680194159714,0.09680757576464583,21.31417506418959,415.52279714475844,246319277848,9685.254736328125,11111.2138671875,9132.2275390625,1.1472299046003187,0.9429000875742285,8.0,0.0,133
2020-07-31,1948.5999755859375,1981.0999755859375,1948.0,1962.800048828125,2914,1860.275,1980.2971725406323,1740.2528274593678,0.0,0.0,12.90370214518093,85.07914428011804,1.0554496980200723,8.543936063051277,39.20116269468258,10638851,1860.275,1962.800048828125,1798.199951171875,1.0551128455890257,0.9666312513858838,8.0,0.0,1.0390133260254413,92.81999969482422,93.54000091552734,92.55000305175781,93.48999786376953,0.0,95.34050064086914,97.94654238931048,92.7344588924278,0.0,0.0,5.4668094480809195,26.825236967015925,0.6026014814965563,-2.6956743525456752,-0.8615389308626078,0.0,95.34050064086914,96.87999725341797,92.93000030517578,1.0161473518829929,0.9747169322639359,0.0,8.0,11110.2109375,11415.8642578125,10987.0537109375,11323.466796875,23160469766,9789.4107421875,11345.454518947838,8233.366965427162,0.0,0.0,31.790346073733772,89.62782360567965,1.9102587010254801,23.271194331189694,459.56684154749746,269479747614,9789.4107421875,11323.466796875,9132.2275390625,1.156705658296314,0.9328679508468404,8.0,0.0,134
2020-08-02,1997.4000244140625,2009.5,1993.5999755859375,1997.9000244140625,932089,1870.2100036621093,2000.7956148963933,1739.6243924278253,0.0,0.0,13.964807265342474,88.48570604719094,1.7882603786816498,10.362921644253282,42.594461295341944,11570940,1870.2100036621093,1997.9000244140625,1798.199951171875,1.0682757660914657,0.9614962745631617,8.0,0.0,1.0530227022594942,93.45500183105469,93.45500183105469,93.31800079345703,93.4219970703125,0.0,95.1721004486084,97.81670629379711,92.5274946034197,0.0,0.0,5.557523334512843,26.252672654892763,-0.07273590224712301,-3.0389221070875614,-0.8419559504205552,0.0,95.1721004486084,96.87999725341797,92.93000030517578,1.0179453515973602,0.9764416238281582,0.0,8.0,11758.7646484375,12034.14453125,11018.1298828125,11053.6142578125,27410067336,10004.065380859374,11798.70659465546,8209.42416706329,0.0,0.0,35.8782384055535,65.78077438418966,-6.0034265575901635,17.90663117318593,498.00730240614394,268145350580,10004.065380859374,11759.5927734375,9132.2275390625,1.1754813993855888,0.9128516449457689,9.0,0.0,135
2020-08-03,1984.300048828125,1984.300048828125,1955.5,1966.0,683,1878.6000061035156,2011.1484442132032,1746.051567993828,0.0,0.0,14.111406119348628,71.90747253246633,-1.596677712810879,8.265872215865537,41.606910331056724,11570257,1878.6000061035156,1997.9000244140625,1798.699951171875,1.0635047471111172,0.9574682983753605,8.0,0.0,1.0292116271879772,93.45999908447266,93.98999786376953,93.31999969482422,93.5,0.0,95.0031005859375,97.62140116932106,92.38480000255394,0.0,0.0,5.512031854192183,28.205773437205593,0.08349524965602928,-2.5432586817958867,-0.8061266341823625,0.0,95.0031005859375,96.69999694824219,92.93000030517578,1.017861484013037,0.9781786039826517,0.0,8.0,11043.7685546875,11453.0791015625,11012.4150390625,11246.3486328125,20271713443,10104.222119140624,11940.927356190985,8267.516882090264,0.0,0.0,36.35520311001585,68.49806890586467,1.7436321777176023,18.067398594131703,488.3300416135862,288417064023,10104.222119140624,11759.5927734375,9132.2275390625,1.1638295986349187,0.9038031261964387,9.0,0.0,136
2020-08-04,1971.0,2016.199951171875,1968.800048828125,2001.199951171875,2010,1888.4350036621095,2026.6021736506864,1750.2678336735326,0.0,0.0,14.6329812485618,77.15509934134633,1.790434952791209,8.619188268210948,43.20301495105855,11572267,1888.4350036621095,2001.199951171875,1798.699951171875,1.0597134385303641,0.9524817892507724,8.0,0.0,1.0363541953246376,93.55999755859375,93.83000183105469,93.2300033569336,93.37999725341797,0.0,94.85060043334961,97.47398700086957,92.22721386582965,0.0,0.0,5.531618261844069,26.984183593402093,-0.1283451835101923,-2.5566153926992516,-0.7760345792826797,0.0,94.85060043334961,96.69999694824219,92.93000030517578,1.0194979948091327,0.9797513129131595,0.0,8.0,11246.203125,11385.3818359375,11094.1455078125,11205.892578125,21250197042,10204.87490234375,12051.377856139057,8358.371948548443,0.0,0.0,36.188644573609054,67.25253083480752,-0.359726129861071,16.95864792012409,469.20773487881524,267166866981,10204.87490234375,11759.5927734375,9132.2275390625,1.1523505075732656,0.8948887297937483,9.0,0.0,137
2020-08-05,2024.0,2050.199951171875,2011.0,2031.0999755859375,1422,1899.4400024414062,2045.9908460230731,1752.8891588597394,0.0,0.0,15.430952637967058,80.57906389361061,1.494104794303719,8.95874696567749,46.22518949000823,11573689,1899.4400024414062,2031.0999755859375,1798.699951171875,1.0693151523476945,0.9469632885797672,8.0,0.0,1.0444284602167022,93.2300033569336,93.25,92.55999755859375,92.83000183105469,0.0,94.65710067749023,97.27719584924134,92.03700550573913,0.0,0.0,5.5359717400982476,22.108163862049295,-0.5889863338405132,-2.407486174730615,-0.7879394656129506,0.0,94.65710067749023,96.6500015258789,92.83000183105469,1.0210538970042908,0.9806977095922182,0.0,8.0,11203.8232421875,11786.6171875,11158.28515625,11747.0224609375,24411254471,10335.6146484375,12229.481322426105,8441.747974448896,0.0,0.0,36.64739327863607,74.21952029196699,4.828976175167332,23.174528440028023,493.77852390517546,291578121452,10335.6146484375,11759.5927734375,9151.392578125,1.1377739179948307,0.885423159570725,9.0,0.0,138
2020-08-06,2045.5,2063.0,2040.0,2051.5,1422,1911.4850036621094,2066.219486031228,1756.750521292991,0.0,0.0,16.189976073332637,82.56054333587242,1.0043830761298445,8.596687656178243,49.42818332759089,11575111,1911.4850036621094,2051.5,1798.699951171875,1.0732493302692114,0.9409961091642594,8.0,0.0,1.050166368057333,92.7699966430664,93.08999633789062,92.5199966430664,92.79000091552734,0.0,94.46410064697265,97.03680043665605,91.89140085728926,0.0,0.0,5.446936501937357,21.789977688401734,-0.043090503865483853,-2.2954620165894544,-0.7865714829747361,0.0,94.46410064697265,96.55999755859375,92.79000091552734,1.0221872319459622,0.9822779265352699,0.0,8.0,11749.87109375,11902.3359375,11598.7138671875,11779.7734375,23400740340,10467.03369140625,12378.653334187635,8555.414048624865,0.0,0.0,36.526483035033735,74.58315826087816,0.2788023660583505,21.728175491383706,506.2525947239501,314978861792,10467.03369140625,11779.7734375,9159.0400390625,1.125416596984067,0.8750368355632931,9.0,0.0,139
2020-08-07,2040.0999755859375,2055.0,2009.5999755859375,2010.0999755859375,808,1921.4200012207032,2074.682929717366,1768.1570727240405,0.0,0.0,15.953089735642672,67.11895418985695,-2.018036773778331,5.945286662880962,47.35891373726622,11574303,1921.4200012207032,2051.5,1798.699951171875,1.0676999295815883,0.9361305440919411,8.0,0.0,1.034907030352349,92.80999755859375,93.62000274658203,92.76000213623047,93.44000244140625,0.0,94.30810089111328,96.7273237346365,91.88887804759007,0.0,0.0,5.130466673942282,37.921394624652805,0.7005081576307415,-1.3200971251146545,-0.7156613466950432,0.0,94.30810089111328,96.3499984741211,92.79000091552734,1.0216513487570422,0.983902761679628,0.0,8.0,11778.89453125,11898.0380859375,11408.59375,11601.47265625,23132312867,10589.155322265626,12462.616227075081,8715.69441745617,0.0,0.0,35.38452025290748,68.71979791808128,-1.513618086086388,17.12546255303345,491.2830713737967,291846548925,10589.155322265626,11779.7734375,9164.2314453125,1.1124374965707495,0.8654355485789349,9.0,0.0,140
2020-08-09,2044.800048828125,2047.5,2028.699951171875,2038.0,825529,1933.3850036621093,2083.7945020455577,1782.9755052786609,0.0,0.0,15.559187445702866,71.15822451563086,1.3879918786591672,6.690401638306076,47.422635526818794,12399832,1933.3850036621093,2051.5,1808.300048828125,1.0610923308674496,0.9353026145351001,8.0,0.0,1.0383125888022942,93.39199829101562,93.48100280761719,93.38899993896484,93.43099975585938,0.0,94.16665077209473,96.43920092733836,91.89410061685109,0.0,0.0,4.826656011678142,37.801407878287876,-0.00963472315030911,-1.0684060350092581,-0.6515564766531696,0.0,94.16665077209473,96.3499984741211,92.79000091552734,1.0231859972094641,0.9853807070201616,0.0,8.0,11737.3251953125,11806.056640625,11548.7841796875,11675.7392578125,17489608833,10843.142138671876,12563.430604430258,9122.853672913494,0.0,0.0,31.73044203899169,68.19076995482925,-0.6662100973708895,6.991004973632027,465.0062456093583,291928997929,10843.142138671876,11779.7734375,9374.8876953125,1.0863800627944962,0.864591423354779,9.0,0.0,141
2020-08-10,2026.4000244140625,2043.800048828125,2017.5,2024.4000244140625,233,1944.1900024414062,2088.007674598933,1800.3723302838794,0.0,0.0,14.794610812413254,66.71908864158223,-0.6673197049037016,4.836873351323796,45.47114796053074,12399599,1944.1900024414062,2051.5,1810.300048828125,1.0551952213640847,0.9311332979569128,8.0,0.0,1.0132639269613963,93.38999938964844,93.69999694824219,93.30000305175781,93.58000183105469,0.0,94.04165077209473,96.14845715834333,91.93484438584612,0.0,0.0,4.480581463535445,41.22155505137078,0.1594781984401994,-0.10674474145531025,-0.5799192464034775,0.0,94.04165077209473,96.3499984741211,92.79000091552734,1.0245460142721285,0.9866904733563143,0.0,7.0,11662.2568359375,12045.140625,11662.2568359375,11878.111328125,26114112569,10968.3033203125,12605.315581230898,9331.291059394101,0.0,0.0,29.84987218372728,71.33119030569017,1.7332698670629254,7.0055025658318355,459.7457232091001,318043110498,10968.3033203125,11878.111328125,9525.36328125,1.0829488373217764,0.8684445536448395,9.0,0.0,142
2020-08-11,2012.4000244140625,2016.0,1904.0,1932.5999755859375,971,1950.304998779297,2080.595105513266,1820.0148920453282,0.0,0.0,13.360998081378852,45.45264832587585,-4.534679298608257,-0.6222026991179828,35.29110492053155,12398628,1950.304998779297,2051.5,1815.9000244140625,1.0518867568324142,0.931085151066444,8.0,0.0,0.983011177815838,93.5999984741211,93.73999786376953,93.16999816894531,93.62999725341797,0.0,93.90565071105956,95.73125937228171,92.08004204983742,0.0,0.0,3.8881763714931386,42.40232317998863,0.053425327404399425,-0.138657081751776,-0.5125185892364783,0.0,93.90565071105956,95.94000244140625,92.79000091552734,1.0216637839676574,0.9881194604681992,0.0,7.0,11881.6474609375,11932.7109375,11195.708984375,11410.525390625,27039782639,11062.56142578125,12568.206689858847,9556.916161703653,0.0,0.0,27.220554194053058,56.907603294606886,-3.9365343915648388,2.6937787987448987,407.40697440702024,291003327859,11062.56142578125,11878.111328125,9536.892578125,1.07372161572302,0.862087197626701,8.0,0.0,143
2020-08-12,1923.0,1946.5999755859375,1871.5999755859375,1934.9000244140625,404,1956.2549987792968,2071.4436489709014,1841.0663485876923,0.0,0.0,11.776445326757736,45.93241853096285,0.11901318727005616,-0.9521359398995393,27.343265946680958,12399032,1956.2549987792968,2051.5,1842.4000244140625,1.0486874161498048,0.9417995228452938,8.0,0.0,0.9668699138639354,93.68000030517578,93.91000366210938,93.2699966430664,93.44000244140625,0.0,93.78065071105956,95.35735463176968,92.20394679034945,0.0,0.0,3.3625356803462134,39.08684525525666,-0.20292087748062793,0.19300911543283478,-0.4701995827764449,0.0,93.78065071105956,95.83000183105469,92.79000091552734,1.0218526007705921,0.9894365224806934,0.0,7.0,11404.5966796875,11748.396484375,11249.60546875,11584.9345703125,25064548486,11162.754541015625,12520.11438054648,9805.39470148477,0.0,0.0,24.31944256309621,60.23963806921132,1.5284938573538076,2.3090788194800793,376.70840146748014,316067876345,11162.754541015625,11878.111328125,9536.892578125,1.064084253082957,0.8543493940571143,7.0,0.0,144
2020-08-13,1921.5,1957.4000244140625,1916.9000244140625,1956.699951171875,71,1961.9699951171874,2064.6599603493373,1859.2800298850377,0.0,0.0,10.46804645205761,50.515950893839296,1.1266694135483313,0.7413840283038706,22.87376381179388,12399103,1961.9699951171874,2051.5,1864.0999755859375,1.0456327085050376,0.9501164544948079,7.0,0.0,0.9633695902179313,93.37000274658203,93.38999938964844,92.93000030517578,93.33999633789062,0.0,93.65615043640136,94.93006614504786,92.38223472775486,0.0,0.0,2.720410144364348,37.377578274309776,-0.10702707716465643,0.4411880247158557,-0.43938907902985136,0.0,93.65615043640136,95.12000274658203,92.79000091552734,1.0156300713125586,0.9907518137694311,0.0,7.0,11588.4052734375,11796.396484375,11216.8720703125,11784.1376953125,27522199497,11275.116796875,12432.90028622777,10117.333307522229,0.0,0.0,20.536966671133033,63.792599701837624,1.7195015111304723,0.20872254973354118,364.70741844353506,343590075842,11275.116796875,11878.111328125,9677.11328125,1.0534801139636198,0.8582716663238557,7.0,0.0,145
2020-08-14,1938.699951171875,1947.4000244140625,1937.0,1937.0,201,1965.6149963378907,2058.894558999845,1872.3354336759367,0.0,0.0,9.491132580463812,46.553336799450506,-1.0067946881726408,-1.3144512016661467,17.463465354000164,12398902,1965.6149963378907,2051.5,1889.0999755859375,1.0436937059506162,0.9610732412529883,6.0,0.0,0.9441871801121131,93.22000122070312,93.41000366210938,93.0199966430664,93.0999984741211,0.0,93.55515022277832,94.65757724709971,92.45272319845694,0.0,0.0,2.356742566702593,33.47430294912209,-0.2571222125408501,-0.4171562718577997,-0.4297518704523924,0.0,93.55515022277832,94.97000122070312,92.79000091552734,1.0151231759508235,0.9918214090252758,0.0,6.0,11772.6591796875,12150.994140625,11685.455078125,11768.87109375,24237958589,11379.7046875,12293.34778778745,10466.061587212549,0.0,0.0,16.057413182101975,63.310849347048986,-0.12955213149429268,6.470796060500927,348.1865102092561,319352117253,11379.7046875,11878.111328125,9905.1669921875,1.0437978536624481,0.870423905030488,6.0,0.0,146
2020-08-16,1956.4000244140625,1959.9000244140625,1945.699951171875,1946.0999755859375,537682,1968.4649963378906,2055.4928329033305,1881.4371597724507,0.0,0.0,8.84220311027582,48.621877385192015,0.4697973973122105,-2.592724770766082,13.943918228545726,12936584,1968.4649963378906,2051.5,1897.300048828125,1.0421826163109766,0.9638474915011646,5.0,0.0,0.9681607876337871,93.09500122070312,93.09500122070312,93.01799774169922,93.0250015258789,0.0,93.45790023803711,94.37078903998645,92.54501143608778,0.0,0.0,1.9535829493797952,32.303038119852076,-0.08055526259007628,-0.4249486811278523,-0.4216694843757267,0.0,93.45790023803711,94.69000244140625,92.79000091552734,1.0131834997387164,0.9928534739084804,0.0,5.0,11866.685546875,11934.9013671875,11737.1884765625,11892.8037109375,20583375490,11522.827783203125,12145.409994070595,10900.245572335656,0.0,0.0,10.80606640281494,65.70376111263317,0.22843551383793237,6.1299100274566065,327.48888713045926,363290417143,11522.827783203125,11892.8037109375,10912.8232421875,1.0321080844646215,0.9470612116667376,4.0,0.0,147
2020-08-17,1949.5999755859375,1985.0,1949.5999755859375,1985.0,97,1972.8499938964844,2053.7123636447986,1891.9876241481702,0.0,0.0,8.197518310918987,56.59999395051422,1.9988708135279865,0.9664292980671414,14.46505353986322,12936681,1972.8499938964844,2051.5,1910.199951171875,1.0398661866572925,0.9682438893385542,4.0,0.0,0.9739941118743867,93.0999984741211,93.12000274658203,92.7699966430664,92.8499984741211,0.0,93.36590003967285,94.1207533775692,92.6110467017765,0.0,0.0,1.6169786561808948,29.61625153436944,-0.1881247502147354,-0.6951887977314506,-0.4235365626378069,0.0,93.36590003967285,94.44000244140625,92.79000091552734,1.011504225860587,0.9938318045035629,0.0,4.0,11895.658203125,12359.056640625,11806.6962890625,12254.40234375,28227687026,11589.90673828125,12224.122335651002,10955.691140911498,1.0,0.0,10.944274387902524,72.10236047179167,3.040482644811049,4.319221185621257,345.1142641971419,391518104169,11589.90673828125,12254.40234375,11053.6142578125,1.0573339907278057,0.9537276276177973,4.0,0.0,148
2020-08-18,2001.0999755859375,2002.800048828125,1972.0999755859375,1999.4000244140625,92,1977.3099975585938,2053.567007492545,1901.0529876246424,0.0,0.0,7.713207340083928,59.20551421226561,0.7254420359729119,-0.08994237466168674,15.847107273010806,12936773,1977.3099975585938,2051.5,1931.0,1.0375206733051516,0.9765792932743105,3.0,0.0,0.9876506620734526,92.81999969482422,92.81999969482422,92.12999725341797,92.2699966430664,0.0,93.25739974975586,93.9869036682798,92.52789583123193,0.0,1.0,1.5644955155976061,22.672056013598834,-0.6246654179712707,-1.1886920571856554,-0.46780132780385486,0.0,93.25739974975586,93.76000213623047,92.2699966430664,1.0053894102540204,0.9894120669315355,0.0,4.0,12251.8955078125,12335.70703125,11954.525390625,11991.2333984375,26043227671,11634.44501953125,12249.747634127698,11019.1424049348,0.0,0.0,10.577257678617473,62.65029173815216,-2.1475461465219614,1.7951105940996586,329.4004266013144,365474876498,11634.44501953125,12254.40234375,11053.6142578125,1.0532863684669103,0.9500766249921089,3.0,0.0,149
2020-08-19,1980.0,1980.0,1938.699951171875,1958.699951171875,347,1978.6949951171875,2052.5042240905705,1904.8857661438046,0.0,0.0,7.460394770848611,49.81381961775717,-2.0356143215570333,-3.5645721670188264,13.071961361462854,12936426,1978.6949951171875,2051.5,1932.5999755859375,1.0367944554681106,0.9767043330856962,2.0,0.0,1.0135051101705743,92.27999877929688,93.05000305175781,92.1500015258789,92.88999938964844,0.0,93.2178997039795,93.9370751427353,92.4987242652237,0.0,0.0,1.5429985894116771,39.5163126466422,0.6719440437181534,0.06463164646160639,-0.43878840399666785,0.0,93.2178997039795,93.76000213623047,92.2699966430664,1.0058154328082103,0.989831319264613,0.0,3.0,11990.884765625,12028.923828125,11687.3330078125,11758.283203125,24502851117,11666.798486328125,12234.885919440925,11098.711053215326,0.0,0.0,9.738531676509536,55.49514845093373,-1.9426708460436926,1.3516434639056127,291.8953536942063,340972025381,11666.798486328125,12254.40234375,11053.6142578125,1.05036547585102,0.9474419456859401,2.0,0.0,150
2020-08-20,1941.199951171875,1948.300048828125,1922.300048828125,1933.800048828125,106,1978.15,2053.1072734351046,1903.1927265648953,0.0,0.0,7.578522704052235,44.96519835963001,-1.2712463860966805,-5.737263035431392,8.635442559750572,12936320,1978.15,2051.5,1932.5999755859375,1.0370801000935217,0.9769734224330497,1.0,0.0,0.9994315077926207,92.95999908447266,93.23999786376953,92.7300033569336,92.79000091552734,0.0,93.16939964294434,93.86628467883564,92.47251460705304,0.0,0.0,1.4959526165500487,38.03168282767325,-0.10765257269690354,0.0,-0.41837111350058365,0.0,93.16939964294434,93.62999725341797,92.2699966430664,1.004943657598297,0.9903465837139153,0.0,3.0,11761.5,11900.4111328125,11710.0634765625,11878.3720703125,20175242944,11694.54375,12246.831247167242,11142.25625283276,0.0,0.0,9.445216657849365,58.22777336107345,1.021312934149976,1.057730869432176,269.47469768493283,361147268325,11694.54375,12254.40234375,11053.6142578125,1.0478734874757298,0.9451941430218258,2.0,0.0,151
2020-08-21,1941.0,1945.0,1908.9000244140625,1934.5999755859375,184,1977.2049987792968,2053.839306741786,1900.5706908168077,0.0,0.0,7.75178173328535,45.155748643951796,0.041365536126503066,-3.756032083826676,5.270992558990429,12936504,1977.2049987792968,2051.5,1932.5999755859375,1.037575770477301,0.977440364949058,0.0,0.0,0.9887054856966181,92.72000122070312,93.47000122070312,92.58000183105469,93.25,0.0,93.16889953613281,93.86553808945548,92.47226098281014,0.0,0.0,1.4954315373286138,48.014344944772304,0.4957420842051974,-0.20334164858931322,-0.35618573333485415,0.0,93.16889953613281,93.62999725341797,92.2699966430664,1.004949051878694,0.9903518996409548,0.0,2.0,11878.0263671875,11899.259765625,11564.9794921875,11592.4892578125,23762425998,11686.18857421875,12239.342253102843,11133.034895334657,0.0,0.0,9.46679364911879,50.0922419806634,-2.406750780391065,-0.7130169504624347,223.45960150170322,337384842327,11686.18857421875,12254.40234375,11053.6142578125,1.0486226767540618,0.9458699205143933,1.0,0.0,152
2020-08-23,1947.9000244140625,1949.0,1938.0999755859375,1943.5999755859375,515338,1977.2699951171876,2053.7878928231517,1900.7520974112238,0.0,0.0,7.739752071788146,47.43111201030077,0.46521245288830837,-4.631993347108072,3.468373856107746,13451842,1977.2699951171876,2051.5,1932.5999755859375,1.0375416635391834,0.9774082347673502,0.0,0.0,1.0034073183200503,93.1989974975586,93.20700073242188,93.14299774169922,93.16799926757812,0.0,93.18079948425293,93.86878526353966,92.4928137049662,0.0,0.0,1.476668547800988,46.529691477369376,-0.08793644227547137,-0.2814916772468298,-0.3110843121519906,0.0,93.18079948425293,93.62999725341797,92.2699966430664,1.0048207116879369,0.9902254236255995,0.0,1.0,11679.6962890625,11713.4296875,11559.9208984375,11664.84765625,18482062657,11738.524072265625,12158.519288719552,11318.528855811699,0.0,0.0,7.155843679636703,51.89436349067935,-0.14533293195752028,2.22883922447562,166.09107502384177,339126970975,11738.524072265625,12254.40234375,11205.892578125,1.0439474561119,0.9546253437943648,1.0,0.0,153
2020-08-24,1930.199951171875,1940.0,1922.199951171875,1927.699951171875,85,1975.514990234375,2054.838571110505,1896.191409358245,0.0,0.0,8.030673648972835,43.85925798900368,-0.8180708280400739,-4.776727527958617,0.6972838911785857,13451757,1975.514990234375,2051.5,1927.699951171875,1.0384633931614005,0.9757961648993474,0.0,0.0,0.9905451802862684,93.19999694824219,93.33999633789062,92.83999633789062,93.30000305175781,0.0,93.17129974365234,93.84708419355992,92.49551529374476,0.0,0.0,1.4506279332088465,49.33198803695529,0.1416836094124685,-0.29920792243878425,-0.26088190542267853,0.0,93.17129974365234,93.62999725341797,92.2699966430664,1.0049231631524693,0.9903263869553635,0.0,1.0,11663.689453125,11807.6318359375,11623.25,11774.595703125,20681511754,11766.959228515625,12108.54775320697,11425.37070382428,0.0,0.0,5.805892891403116,55.02014858516822,0.9408442365399949,1.6371359860635273,152.60366938131847,359808482729,11766.959228515625,12254.40234375,11410.525390625,1.041424730533027,0.9697089255627863,1.0,0.0,154
2020-08-25,1927.5,1928.5,1911.800048828125,1911.800048828125,176,1971.2099914550781,2054.455407098753,1887.9645758114034,0.0,0.0,8.4461235489402,40.47278482062212,-0.8248120945422155,-1.0762665331973964,-2.7427315479667413,13451581,1971.2099914550781,2051.5,1911.800048828125,1.040731331970195,0.9698611802474181,0.0,0.0,0.9631234502912468,93.27999877929688,93.3499984741211,92.97000122070312,93.0199966430664,0.0,93.15119972229004,93.81983809617559,92.4825613484045,0.0,0.0,1.4355979866688606,43.90838441587647,-0.30011404022792787,-0.651501258406044,-0.24344462837257197,0.0,93.15119972229004,93.62999725341797,92.2699966430664,1.0051400039135874,0.9905400780467589,0.0,1.0,11773.5888671875,11778.2998046875,11189.8505859375,11366.134765625,26301509931,11747.91484375,12131.691498728418,11364.138188771583,0.0,0.0,6.533528035957634,43.36720162076846,-3.4690018052305094,-3.5471660336570356,104.61241486878134,333506972798,11747.91484375,12254.40234375,11366.134765625,1.0431129699811754,0.9675023114141731,1.0,0.0,155
