Date,Open,High,Low,Close,Volume,boll_mavg,boll_hband,boll_lband,boll_hband_ind,boll_lband_ind,boll_bandwidth,RSI,daily_return,ROC,MACD,on_balance_volume,avg_close,max_close,min_close,max_close_pct,min_close_pct,boll_hband_num,boll_lband_num,pct_change,Future,DX-Y.NYB_Open,DX-Y.NYB_High,DX-Y.NYB_Low,DX-Y.NYB_Close,DX-Y.NYB_Volume,DX-Y.NYB_boll_mavg,DX-Y.NYB_boll_hband,DX-Y.NYB_boll_lband,DX-Y.NYB_boll_hband_ind,DX-Y.NYB_boll_lband_ind,DX-Y.NYB_boll_bandwidth,DX-Y.NYB_RSI,DX-Y.NYB_daily_return,DX-Y.NYB_ROC,DX-Y.NYB_MACD,DX-Y.NYB_on_balance_volume,DX-Y.NYB_avg_close,DX-Y.NYB_max_close,DX-Y.NYB_min_close,DX-Y.NYB_max_close_pct,DX-Y.NYB_min_close_pct,DX-Y.NYB_boll_hband_num,DX-Y.NYB_boll_lband_num,BTC-USD_Open,BTC-USD_High,BTC-USD_Low,BTC-USD_Close,BTC-USD_Volume,BTC-USD_boll_mavg,BTC-USD_boll_hband,BTC-USD_boll_lband,BTC-USD_boll_hband_ind,BTC-USD_boll_lband_ind,BTC-USD_boll_bandwidth,BTC-USD_RSI,BTC-USD_daily_return,BTC-USD_ROC,BTC-USD_MACD,BTC-USD_on_balance_volume,BTC-USD_avg_close,BTC-USD_max_close,BTC-USD_min_close,BTC-USD_max_close_pct,BTC-USD_min_close_pct,BTC-USD_boll_hband_num,BTC-USD_boll_lband_num,day
2020-08-26,1909.699951171875,1950.800048828125,1909.699951171875,1940.699951171875,287,1969.9449890136718,2054.231061471731,1885.6589165556124,0.0,0.0,8.557200625207347,48.50300823051136,1.5116592533547024,0.2997533042860376,-2.7395872493825664,13451868,1969.9449890136718,2051.5,1911.800048828125,1.041399638792534,0.9704839777202817,0.0,0.0,0.9706411560841158,1927.5999755859375,93.0199966430664,93.36000061035156,92.8499984741211,93.01000213623047,0.0,93.12669982910157,93.77810701426536,92.47529264393778,0.0,0.0,1.3989697613234433,43.717764549941116,-0.010744471292867264,-0.46018867074133807,-0.22718634805941917,0.0,93.12669982910157,93.62999725341797,92.2699966430664,1.0054044374517728,0.990800670617478,0.0,1.0,11366.89453125,11530.052734375,11296.9931640625,11488.36328125,22466660957,11733.3443359375,12132.97633019579,11333.71234167921,0.0,0.0,6.811902605368475,47.092898185884174,1.0753745063331488,-2.3834725545508526,77.85750634662145,355973633755,11733.3443359375,12254.40234375,11366.134765625,1.0444083112959173,0.9687037591500839,1.0,0.0,156
2020-08-27,1948.9000244140625,1972.5,1921.5999755859375,1921.5999755859375,2303,1965.964990234375,2051.480216843651,1880.4497636250987,0.0,0.0,8.699567594953077,44.13128588274498,-0.984179732390067,-1.7938353586054925,-4.343498451388314,13449565,1965.964990234375,2051.5,1911.800048828125,1.0435079007970676,0.9724486744803159,0.0,0.0,0.9810588775663466,1923.9000244140625,92.8499984741211,93.31999969482422,92.41999816894531,93.01000213623047,0.0,93.10820007324219,93.7507373175221,92.46566282896228,0.0,0.0,1.3801947492797946,43.717764549941116,0.0,-0.3535399770807552,-0.21121703496075384,0.0,93.10820007324219,93.62999725341797,92.2699966430664,1.0056042022052334,0.9909975337347686,0.0,1.0,11485.6083984375,11570.7861328125,11185.94140625,11323.3974609375,23240415075,11719.440576171875,12154.25747186029,11284.62368048346,0.0,0.0,7.42043773953665,42.86414313083375,-1.435938403704018,-4.570323382419206,42.42098777984211,332733218680,11719.440576171875,12254.40234375,11323.3974609375,1.0456473808712181,0.96620631226719,1.0,0.0,157
2020-08-28,1927.0999755859375,1971.300048828125,1922.5,1964.5999755859375,778,1962.639990234375,2042.7679558374296,1882.5120246313206,0.0,0.0,8.16532486872294,54.4101513340434,2.2377185962904944,1.4248825805853123,-1.7326535238448741,13450343,1962.639990234375,2051.5,1911.800048828125,1.0452757562302668,0.9740961451620178,0.0,0.0,1.0159271517117177,1933.0,93.0199966430664,93.0999984741211,92.19999694824219,92.29000091552734,0.0,93.08120002746583,93.80807637206986,92.35432368286179,0.0,1.0,1.5618112881861312,31.539966368054863,-0.7741116053825547,-0.8700296153269048,-0.2580759255856435,0.0,93.08120002746583,93.62999725341797,92.2699966430664,1.0058958976226156,0.9912849921986389,0.0,2.0,11325.2958984375,11545.615234375,11316.4228515625,11542.5,19807127587,11708.86328125,12150.043860988091,11267.682701511909,0.0,0.0,7.535839630898692,49.54962125864128,1.934954061432026,-2.945509902053919,34.42411399287812,352540346267,11708.86328125,12254.40234375,11323.3974609375,1.0465919747627082,0.9670791424365023,1.0,0.0,158
2020-08-30,1973.9000244140625,1984.5999755859375,1973.4000244140625,1984.0,760408,1959.264990234375,2029.1717717939089,1889.3582086748413,0.0,0.0,7.136021100562946,58.259810118539164,0.9874796220679327,1.9474859919594547,1.9097083159240356,14210751,1959.264990234375,2038.0,1911.800048828125,1.0401859932975204,0.9757741083299957,0.0,0.0,1.0255350072560094,1944.699951171875,92.29900360107422,92.36299896240234,92.22599792480469,92.22899627685547,0.0,93.05314979553222,93.86153882332201,92.24476076774243,0.0,1.0,1.7374780532761716,30.733999801279523,-0.06610102726914979,-0.8556895844844403,-0.29357661549019554,0.0,93.05314979553222,93.62999725341797,92.22899627685547,1.0061991180218324,0.9911431958994652,0.0,3.0,11508.7138671875,11715.2646484375,11492.3818359375,11711.505859375,19760127944,11692.089306640624,12134.50139668045,11249.677216600798,0.0,0.0,7.567716572068173,54.53129150828478,1.7784220187846422,-2.3327670287774525,35.00365047318701,354814876452,11692.089306640624,12254.40234375,11323.3974609375,1.0480934606606198,0.9684665558025012,1.0,0.0,159
2020-08-31,1970.0,1971.300048828125,1953.300048828125,1967.5999755859375,158,1957.139990234375,2023.2153325114743,1891.0646479572758,0.0,0.0,6.752234649212443,53.97851899745008,-0.8266141337733068,-0.8765755372323677,3.1530180694110186,14210593,1957.139990234375,2038.0,1911.800048828125,1.0413153939774853,0.9768335726455518,0.0,0.0,1.0123482199534215,1954.199951171875,92.30000305175781,92.4800033569336,91.98999786376953,92.13999938964844,0.0,92.98814964294434,93.8675986066337,92.10870067925497,0.0,0.0,1.8915291186377532,29.511587204492443,-0.0964955608319551,-0.7646732322462507,-0.322478127420311,0.0,92.98814964294434,93.62999725341797,92.13999938964844,1.0069024667437538,0.990878942568998,0.0,3.0,11713.306640625,11768.876953125,11598.318359375,11680.8203125,22285928250,11705.604052734376,12128.886008705655,11282.322096763097,0.0,0.0,7.232124955950516,53.491175574585,-0.26201196706430174,-0.6587942243508192,39.27709455635886,332528948202,11705.604052734376,12254.40234375,11323.3974609375,1.046883380690416,0.9673484093537579,1.0,0.0,160
2020-09-01,1961.699951171875,1986.300048828125,1961.699951171875,1968.199951171875,186,1953.6499877929687,2008.7319875769283,1898.567988009009,0.0,0.0,5.638881081885664,54.11558113656324,0.03049276242030885,-1.5604717845960259,4.0707384472784724,14210779,1953.6499877929687,2024.4000244140625,1911.800048828125,1.036214284576645,0.9785785891913416,0.0,0.0,1.021009493710564,1937.800048828125,92.18000030517578,92.4000015258789,91.75,92.33999633789062,0.0,92.9335994720459,93.83155542420766,92.03564351988413,0.0,0.0,1.932467820601026,35.879560926455284,0.21705768348925236,0.07586398327833781,-0.3209729632017968,0.0,92.9335994720459,93.62999725341797,92.13999938964844,1.0074934984260622,0.9914605687619344,0.0,3.0,11679.31640625,12067.0810546875,11601.12890625,11970.478515625,27311555343,11724.88125,12159.3932110942,11290.3692889058,0.0,0.0,7.411792952601548,61.244363265000985,2.4797762089964426,0.775413034440138,66.8390626191158,359840503545,11724.88125,12254.40234375,11323.3974609375,1.0451621711520531,0.9657579654324857,1.0,0.0,161
2020-09-02,1967.300048828125,1967.300048828125,1934.4000244140625,1934.4000244140625,71,1949.1499877929687,1994.161379482637,1904.1385961033004,0.0,0.0,4.618566243907668,45.612431686823804,-1.7173014732414726,-1.2406150693613915,1.753200333295581,14210708,1949.1499877929687,1999.4000244140625,1911.800048828125,1.025780487359001,0.980837832286506,0.0,0.0,1.0118213071496627,1953.0999755859375,92.27999877929688,92.87000274658203,92.20999908447266,92.8499984741211,0.0,92.89709930419922,93.74493564833396,92.04926296006447,0.0,0.0,1.8253236117920932,48.94748948207648,0.5523090280015408,-0.043062671751725096,-0.2701447482287165,0.0,92.89709930419922,93.62999725341797,92.13999938964844,1.0078893523555437,0.9918501231984479,0.0,3.0,11964.8232421875,11964.8232421875,11290.7939453125,11414.0341796875,28037405298,11706.37607421875,12160.307559327797,11252.444589109702,0.0,0.0,7.755286217205211,45.171238445093984,-4.648471948812871,-1.5394025748588396,37.907692790135116,331803098247,11706.37607421875,12254.40234375,11323.3974609375,1.0468143399850431,0.9672846138845058,1.0,0.0,162
2020-09-03,1937.0999755859375,1938.800048828125,1923.0,1927.5999755859375,179,1948.8999877929687,1994.3298833052281,1903.4700922807092,0.0,0.0,4.6621063981540205,44.06467799358088,-0.3515327100031884,-0.32061604538404676,-0.5814870926212734,14210529,1948.8999877929687,1999.4000244140625,1911.800048828125,1.0259120719058974,0.9809636517023854,0.0,0.0,0.9932498707087475,1956.300048828125,92.66000366210938,93.06999969482422,92.6500015258789,92.73999786376953,0.0,92.8525993347168,93.6326081609638,92.0725905084698,0.0,0.0,1.6801012181365174,46.66813786073914,-0.11847131088776885,-0.0538884052855366,-0.23736469824483208,0.0,92.8525993347168,93.44000244140625,92.13999938964844,1.0063261891524649,0.9923254712288714,0.0,3.0,11407.19140625,11443.0224609375,10182.46484375,10245.296875,31927261554,11630.19736328125,12410.588527350656,10849.806199211844,0.0,1.0,13.42008462441488,28.013642246558078,-10.23947612464131,-12.297122207315066,-85.35482281881013,299875836693,11630.19736328125,12254.40234375,10245.296875,1.0536710565582905,0.8809220131849487,1.0,1.0,163
2020-09-04,1927.9000244140625,1939.699951171875,1917.699951171875,1923.9000244140625,607,1948.3499877929687,1994.7015276284692,1901.9984479574682,0.0,0.0,4.75803014098161,43.17888648334247,-0.19194600636733838,-0.5530833922725692,-2.620035252356047,14209922,1948.3499877929687,1999.4000244140625,1911.800048828125,1.0262016767731355,0.9812405680735798,0.0,0.0,1.001196944659319,1960.199951171875,92.80000305175781,93.23999786376953,92.66000366210938,92.80000305175781,0.0,92.82059936523437,93.55262570948864,92.0885730209801,0.0,0.0,1.5772928622748008,48.13210301770409,0.06470259798412314,-0.4825704538790215,-0.2037934813617568,0.0,92.82059936523437,93.33999633789062,92.13999938964844,1.005595708023954,0.9926675761604611,0.0,3.0,10230.365234375,10663.919921875,10207.9404296875,10511.8134765625,29965130373,11562.503125,12473.406358166392,10651.599891833606,0.0,1.0,15.756159774726857,34.33344506642085,2.601355576262887,-9.884691285013968,-152.04806457900486,329840967066,11562.503125,12254.40234375,10245.296875,1.0598399162594823,0.8860794902487865,1.0,2.0,164
2020-09-08,1930.9000244140625,1937.9000244140625,1903.0999755859375,1933.0,271,1947.164990234375,1993.8129099696594,1900.5170704990906,0.0,0.0,4.7913679600072845,46.13776418290966,0.4729962820551936,-0.5453784584835634,-3.295845133682633,14210193,1947.164990234375,1999.4000244140625,1911.800048828125,1.0268261983148126,0.9818377273710158,0.0,0.0,0.9839153130517001,1940.0,93.05000305175781,93.5,93.0,93.4800033569336,0.0,92.82759971618653,93.58170490171526,92.0734945306578,0.0,0.0,1.6247434767986024,61.45479870901113,0.7327589254458644,0.33488332024753936,-0.1165386843229328,0.0,92.82759971618653,93.4800033569336,92.13999938964844,1.0070281214072296,0.9925927167282104,0.0,3.0,10369.306640625,10414.775390625,9945.1103515625,10131.5166015625,33430927462,11215.216943359375,12478.673884898973,9951.760001819777,0.0,0.0,22.531119066541137,32.22950923281857,-2.2956306264775628,-10.525823751101646,-320.73407043196676,322268032896,11215.216943359375,11970.478515625,10131.5166015625,1.0673425735837256,0.9033723246487404,0.0,3.0,165
2020-09-09,1926.9000244140625,1946.199951171875,1924.5999755859375,1944.699951171875,219,1947.5499877929688,1993.9825776558225,1901.117397930115,0.0,0.0,4.768307889798792,49.86717930675405,0.6052742458290128,0.8818799829125621,-2.7260662840492387,14210412,1947.5499877929688,1999.4000244140625,1911.800048828125,1.0266232122133367,0.9816436347262353,0.0,0.0,0.9801915076471144,1952.0999755859375,93.58000183105469,93.66000366210938,93.13999938964844,93.26000213623047,0.0,92.83559989929199,93.60434743459182,92.06685236399217,0.0,0.0,1.6561481503512883,56.26002249270035,-0.23534575610048014,-0.042873434318274777,-0.06897720979104349,0.0,92.83559989929199,93.4800033569336,92.13999938964844,1.0069413399422273,0.9925071792459128,0.0,3.0,10134.1513671875,10350.54296875,10017.2509765625,10242.34765625,24128292754,11133.41572265625,12426.047793189007,9840.783652123491,0.0,0.0,23.220763559601586,35.23966500657721,1.0939236349907233,-11.264044563569417,-327.74310997182147,346396325650,11133.41572265625,11970.478515625,10131.5166015625,1.0751847244206778,0.9100097269290944,0.0,3.0,166
2020-09-10,1944.0999755859375,1962.699951171875,1944.0999755859375,1954.199951171875,722,1947.9549865722656,1994.4711472138654,1901.4388259306659,0.0,0.0,4.775896872591731,52.81472079326821,0.4885072370303334,2.217800045027713,-1.434566507324007,14211134,1947.9549865722656,1999.4000244140625,1911.800048828125,1.0264097672669135,0.9814395414712529,0.0,0.0,0.9931896602051583,1901.199951171875,93.2300033569336,93.44999694824219,92.69999694824219,93.33999633789062,0.0,92.85134963989258,93.64739556440765,92.0553037153775,0.0,0.0,1.714667428319335,57.70445282326348,0.08577546625325727,0.3440117247607653,-0.025649049542906255,0.0,92.85134963989258,93.4800033569336,92.13999938964844,1.0067705393564998,0.992338827028331,0.0,3.0,10242.330078125,10503.912109375,10238.1357421875,10363.138671875,54406443210,11071.948193359374,12388.116984204316,9755.779402514432,0.0,0.0,23.774836512229005,38.545149787000945,1.1793293850096198,-9.939514708865207,-316.79831780267887,400802768860,11071.948193359374,11970.478515625,10131.5166015625,1.0811537686569503,0.9150617781646668,0.0,3.0,167
2020-09-11,1944.0,1949.5,1937.800048828125,1937.800048828125,73,1945.594989013672,1989.041885278815,1902.1480927485288,0.0,0.0,4.466180938014102,47.46217303015825,-0.8392131180801399,-0.14942558956622423,-1.873585204405117,14211061,1945.594989013672,1999.4000244140625,1911.800048828125,1.027654797480573,0.9826300230128165,0.0,0.0,0.9845544644355622,1898.5999755859375,93.33000183105469,93.37999725341797,93.0999984741211,93.33000183105469,0.0,92.87534980773925,93.69827526037847,92.05242435510004,0.0,0.0,1.772107355380614,57.44112223367368,-0.010707635770368373,0.3440486909736004,0.006003857227156573,0.0,92.87534980773925,93.4800033569336,92.13999938964844,1.006510377085481,0.9920823940947403,0.0,3.0,10369.0283203125,10434.9228515625,10140.8369140625,10400.9150390625,45201121774,11007.902685546875,12323.79025104829,9692.015120045458,0.0,0.0,23.90805229826653,39.616150888033516,0.36452631180188266,-11.190626005308948,-299.9399624958205,446003890634,11007.902685546875,11970.478515625,10131.5166015625,1.0874440715525189,0.9203857347744316,0.0,3.0,168
2020-09-14,1946.300048828125,1953.0999755859375,1943.0,1953.0999755859375,55,1943.2799865722657,1979.314198755436,1907.2457743890952,0.0,0.0,3.7085970557161825,52.45676352448425,0.789551366100194,1.6392589717011714,-0.8414610538725356,14211116,1943.2799865722657,1984.0,1911.800048828125,1.020954269950343,0.9838006165031999,0.0,0.0,1.0096670548675883,1859.9000244140625,93.29000091552734,93.33000183105469,92.87000274658203,93.06999969482422,0.0,92.91534996032715,93.69322750640094,92.13747241425335,0.0,0.0,1.6743789834638367,50.747248423609605,-0.2785836613408921,0.06450656619260411,0.006820259409678897,0.0,92.91534996032715,93.4800033569336,92.13999938964844,1.006077073345228,0.991655301615828,0.0,2.0,10328.734375,10800.0107421875,10266.0087890625,10680.837890625,35453581939,10839.96201171875,12092.24589651016,9587.67812692734,0.0,0.0,23.10494969332188,48.93498052947547,3.45883839286778,-6.423638457008492,-225.20542327875046,481700697107,10839.96201171875,11970.478515625,10131.5166015625,1.1042915558822146,0.9346450283321684,0.0,3.0,169
2020-09-15,1955.800048828125,1968.5,1955.800048828125,1956.300048828125,74,1943.1599914550782,1979.0034873075729,1907.3164956025835,0.0,0.0,3.689196567458591,53.48443461991966,0.16384584927493506,-0.42247413524155547,0.21421227426731093,14211190,1943.1599914550782,1984.0,1911.800048828125,1.0210173164971044,0.9838613687164945,0.0,0.0,1.014889019301561,1868.300048828125,93.05999755859375,93.13999938964844,92.79000091552734,93.05000305175781,0.0,92.92335014343261,93.70330862033157,92.14339166653366,0.0,0.0,1.678713640210008,50.24686690514331,-0.021485594855463752,0.8234934756649267,0.005575198259222702,0.0,92.92335014343261,93.4800033569336,92.13999938964844,1.005990455710451,0.9915699256153052,0.0,2.0,10677.7548828125,10938.6318359375,10656.4599609375,10796.951171875,32509451925,10805.39140625,12021.82864929266,9588.954163207341,0.0,0.0,22.51537583986182,51.92104654543391,1.0871177190313608,5.384463755473167,-179.28176027150948,514210149032,10805.39140625,11970.478515625,10131.5166015625,1.1078246095464062,0.9376353174677484,0.0,3.0,170
2020-09-16,1961.300048828125,1961.4000244140625,1956.699951171875,1960.199951171875,124,1944.4799865722657,1980.7888971414945,1908.171076003037,0.0,0.0,3.7345625380525793,54.80720927093429,0.19935093014418204,-1.1995992352885585,1.3296293170803892,14211314,1944.4799865722657,1984.0,1911.800048828125,1.0203242068319769,0.9831934820775662,0.0,0.0,1.0188678862192269,1857.699951171875,93.08000183105469,93.27999877929688,92.77999877929688,93.20999908447266,0.0,92.94435005187988,93.73140047010646,92.1572996336533,0.0,0.0,1.693594969005146,54.25669632868687,0.17194629496770641,1.0636598545129854,0.018409459750728274,0.0,92.94435005187988,93.4800033569336,92.13999938964844,1.0057631615558635,0.9913458896449061,0.0,2.0,10797.76171875,11100.1240234375,10704.884765625,10974.9052734375,30769986454,10787.966796875,11984.037879172758,9591.895714577242,0.0,0.0,22.17417062581671,56.27505045708189,1.648188444401355,4.405441534018135,-126.77459383612222,544980135486,10787.966796875,11970.478515625,10131.5166015625,1.1096139560878648,0.9391497760724795,0.0,3.0,171
2020-09-17,1939.0,1946.0,1933.699951171875,1940.0,67,1944.7499877929688,1980.8406585626715,1908.659317023266,0.0,0.0,3.7116000510338885,47.099002634392946,-1.0305046258060946,-1.4027229075218106,0.38339024182164394,14211247,1944.7499877929688,1984.0,1911.800048828125,1.0201825491468828,0.9830569794720824,0.0,0.0,1.0036213140196586,1872.800048828125,93.1500015258789,93.58999633789062,92.87000274658203,92.97000122070312,0.0,92.93035011291504,93.70501880726238,92.1556814185677,0.0,0.0,1.6672027887683178,47.831647192393824,-0.2574808133535389,0.9008051188981612,0.006812332480819805,0.0,92.93035011291504,93.4800033569336,92.13999938964844,1.0059146795783154,0.9914952357081805,0.0,2.0,10973.251953125,11037.4208984375,10774.6279296875,10948.990234375,38151810523,10758.29130859375,11906.500842629788,9610.081774557713,0.0,0.0,21.34557433147111,55.46234459914221,-0.23612995663134795,7.6642675368845685,-87.95414771254946,506828324963,10758.29130859375,11970.478515625,10131.5166015625,1.1126746964048977,0.9417403108864898,0.0,3.0,172
2020-09-18,1950.5,1952.0999755859375,1949.0,1952.0999755859375,38,1945.1749877929688,1981.4014142673418,1908.9485613185957,0.0,0.0,3.7247473056885463,51.62703986436327,0.6237100817493513,-0.8180050800403436,0.7239056915282163,14211285,1945.1749877929688,1984.0,1911.800048828125,1.019959650134656,0.9828421920010849,0.0,0.0,1.003805226821548,1894.300048828125,92.86000061035156,93.01000213623047,92.7699966430664,92.93000030517578,0.0,92.91845016479492,93.68542457849556,92.15147575109428,0.0,0.0,1.6508549428888988,46.80519850302904,-0.04302561579232478,0.6389473583323667,-0.005353799136614157,0.0,92.91845016479492,93.4800033569336,92.13999938964844,1.0060435057961334,0.9916222152461016,0.0,2.0,10951.8203125,11034.908203125,10829.6572265625,10944.5859375,26341903912,10730.17734375,11830.219209887042,9630.135477612957,0.0,0.0,20.503703357294146,55.311505065447676,-0.040225598714782596,6.46120291666825,-58.07524320830089,480486421051,10730.17734375,11970.478515625,10131.5166015625,1.115589997456793,0.944207749507868,0.0,3.0,173
2020-09-21,1946.199951171875,1946.199951171875,1883.4000244140625,1901.199951171875,52,1943.8499877929687,1984.2358375832944,1903.464138002643,0.0,1.0,4.155243464664619,36.87458590146984,-2.6074496721810836,-1.7162982228685577,-3.4434881143051825,14211233,1943.8499877929687,1984.0,1901.199951171875,1.0206548923317984,0.9780589876333419,0.0,1.0,0.9728789267606841,1887.5,93.01000213623047,93.77999877929688,92.75,93.54000091552734,0.0,92.93045005798339,93.72783472523162,92.13306539073517,0.0,0.0,1.7160891112669756,60.98981853478276,0.65640870369994,0.7431367288590378,0.038546715568998025,0.0,92.93045005798339,93.54000091552734,92.13999938964844,1.0065592155979404,0.9914941693724526,0.0,2.0,10934.92578125,10988.3046875,10380.2607421875,10462.259765625,28884999243,10586.781005859375,11291.314602015493,9882.247409703257,0.0,0.0,13.309684894137048,40.36245286209833,-4.351800185522626,2.1470869448647063,-39.41361013649475,449666102028,10586.781005859375,11414.0341796875,10131.5166015625,1.0781401989301822,0.9569968998088367,0.0,3.0,174
2020-09-22,1913.0999755859375,1913.0999755859375,1898.5999755859375,1898.5999755859375,331,1943.1899841308593,1986.0075908758424,1900.3723773858762,0.0,1.0,4.406939835492652,36.28609994195598,-0.13675445259373475,-1.5044615255914182,-6.693920582093369,14210902,1943.1899841308593,1984.0,1898.5999755859375,1.021001557337377,0.9770531914485624,0.0,2.0,0.9797708369003842,1908.4000244140625,93.55000305175781,94.08000183105469,93.47000122070312,93.98999786376953,0.0,92.97895011901855,93.9005454077707,92.0573548302664,1.0,0.0,1.9823740482602727,67.98684849603151,0.48107434663011706,1.3478542471352957,0.10933779832757295,0.0,92.97895011901855,93.98999786376953,92.13999938964844,1.0108739423649846,0.9909769821201874,1.0,2.0,10459.6240234375,10568.0771484375,10382.7265625,10538.4599609375,23621787803,10543.002294921875,11136.549856573003,9949.454733270746,0.0,0.0,11.259554822197385,42.88332157050104,0.7283340025915352,1.6917778929110787,-55.09076609220574,473287889831,10543.002294921875,11094.3466796875,10131.5166015625,1.0522948178652285,0.9609707290344071,0.0,3.0,175
2020-09-23,1875.5,1875.5,1859.9000244140625,1859.9000244140625,5,1939.1499877929687,1995.3128277391918,1882.9871478467455,0.0,1.0,5.792521496508325,28.70868746407514,-2.038341497393714,-3.326576183161683,-12.33481795482453,14210897,1939.1499877929687,1984.0,1859.9000244140625,1.0231286968462285,0.9591315968966877,0.0,3.0,0.9522810136004868,1900.199951171875,93.98999786376953,94.43000030517578,93.93000030517578,94.38999938964844,0.0,93.04794998168946,94.15624286506018,91.93965709831873,1.0,0.0,2.3821973156610534,72.80456596501402,0.4255788221834811,1.713358066382636,0.19448045839676809,0.0,93.04794998168946,94.38999938964844,92.13999938964844,1.0144232023190525,0.9902421214844638,2.0,2.0,10539.45703125,10637.84765625,10185.7744140625,10225.8642578125,22986733996,10542.0306640625,11137.584637420112,9946.476690704889,0.0,0.0,11.298657580039851,35.955720636951455,-2.9662370430184937,-1.6830325081261162,-92.8065438695121,450301155835,10542.0306640625,11094.3466796875,10131.5166015625,1.0523918050729857,0.9610592991443829,0.0,2.0,176
2020-09-24,1851.5,1868.300048828125,1851.5,1868.300048828125,365,1936.4849914550782,2000.267418137294,1872.7025647728624,0.0,1.0,6.587443431130298,32.126951562133655,0.45163849152101143,-3.34712628928479,-15.56968241645427,14211262,1936.4849914550782,1984.0,1859.9000244140625,1.0245367295665013,0.9604515566198788,0.0,4.0,0.9550171252857074,1912.5,94.37999725341797,94.58999633789062,94.19999694824219,94.3499984741211,0.0,93.11494979858398,94.35959242239545,91.8703071747725,0.0,0.0,2.6733464959251907,71.60717707364026,-0.04237834069922286,0.9306751026373072,0.25067723210973725,0.0,93.11494979858398,94.38999938964844,92.13999938964844,1.0136932854909175,0.989529603881606,2.0,2.0,10227.4794921875,10765.794921875,10215.205078125,10745.548828125,23017536741,10553.717431640625,11155.580809802921,9951.85405347833,0.0,0.0,11.405713333917321,50.67472071186565,5.08206012920096,2.9053147342464536,-74.12464091795846,473318692576,10553.717431640625,11094.3466796875,10131.5166015625,1.0512264281802768,0.9599950602417737,0.0,1.0,177
2020-09-25,1856.300048828125,1857.699951171875,1856.300048828125,1857.699951171875,4,1931.139990234375,2002.1135617185862,1860.166418750164,0.0,1.0,7.350432577971451,30.103150752986394,-0.5673659144257326,-4.473697854909384,-18.612474825103163,14211258,1931.139990234375,1984.0,1857.699951171875,1.0273724380588325,0.9619706290409392,0.0,5.0,0.9477094161038409,1901.0999755859375,94.31999969482422,94.73999786376953,94.19000244140625,94.58000183105469,0.0,93.22944984436035,94.56730692892326,91.89159275979743,1.0,0.0,2.870031061636352,74.30687555261827,0.2437767468503882,1.4153974529145046,0.3078504204870285,0.0,93.22944984436035,94.58000183105469,92.13999938964844,1.0144863236772177,0.9883143099467961,3.0,1.0,10747.47265625,10757.548828125,10594.0478515625,10702.2900390625,21232549821,10580.353564453126,11158.542204622065,10002.164924284187,0.0,0.0,10.92947672583424,49.619977941567555,-0.4025740309259618,3.6666324237390135,-62.75698642818497,452086142755,10580.353564453126,11094.3466796875,10131.5166015625,1.0485799564355995,0.957578264265328,0.0,0.0,178
2020-09-28,1872.800048828125,1872.800048828125,1872.800048828125,1872.800048828125,10455,1925.5799926757813,1996.541018485663,1854.6189668658997,0.0,0.0,7.370353460234534,36.44047953328234,0.812838351356171,-4.165382477618881,-19.23526984438263,14221713,1925.5799926757813,1968.199951171875,1857.699951171875,1.0221335694482725,0.9647482619459603,0.0,5.0,0.9653608499114046,1883.5999755859375,94.58000183105469,94.63999938964844,94.1500015258789,94.26000213623047,0.0,93.3310001373291,94.65796579921194,92.00403447544626,0.0,0.0,2.843568931931114,64.7843972756876,-0.3383375857782589,0.9856501333141522,0.31713708556964093,0.0,93.3310001373291,94.58000183105469,92.13999938964844,1.0133824955469006,0.9872389586961653,3.0,0.0,10771.6416015625,10949.123046875,10716.6767578125,10721.3271484375,22720365388,10653.791552734376,11166.744308149142,10140.83879731961,0.0,0.0,9.629487359044735,49.86535017108388,-0.4928300184183554,-2.310526776151168,-30.180524690462335,465487669709,10653.791552734376,11094.3466796875,10225.8642578125,1.0413519566975245,0.9598333332500724,0.0,0.0,179
2020-09-29,1876.5,1895.4000244140625,1872.4000244140625,1894.300048828125,3283,1921.9149963378907,1991.3721023532742,1852.4578903225072,0.0,0.0,7.2279061402539035,44.413681183096244,1.148013639440748,-2.24481364970067,-17.501749796413833,14224996,1921.9149963378907,1968.199951171875,1857.699951171875,1.0240827273433935,0.9665879889129466,0.0,5.0,0.9703908982733,1888.5999755859375,94.23999786376953,94.30000305175781,93.81999969482422,93.88999938964844,0.0,93.4185001373291,94.64691877299029,92.19008150166792,0.0,0.0,2.629925836649826,55.6261409189995,-0.39253420135433315,0.6000188016790717,0.28648520875235306,0.0,93.4185001373291,94.58000183105469,92.33999633789062,1.0124333155854368,0.9884551368534815,3.0,0.0,10712.462890625,10858.939453125,10665.3447265625,10848.830078125,20459870041,10684.115673828124,11167.01639788394,10201.21494977231,0.0,0.0,9.039601194860357,53.8778348828308,1.1892457708100324,-0.9147889815038951,-14.466445701918929,485947539750,10684.115673828124,11094.3466796875,10225.8642578125,1.0383963463503376,0.9571090926001335,0.0,0.0,180
2020-09-30,1893.0,1899.699951171875,1879.800048828125,1887.5,600,1917.8799987792968,1985.4639002694548,1850.2960972891387,0.0,0.0,7.047771657577558,42.53840846694915,-0.3589742201786761,-3.358761784135359,-16.504182909721976,14224396,1917.8799987792968,1960.199951171875,1857.699951171875,1.0220660064339344,0.9686215781770885,0.0,5.0,0.9927940503241489,1919.5,93.8499984741211,94.19000244140625,93.66999816894531,93.88999938964844,0.0,93.49600028991699,94.63477834983122,92.35722223000276,0.0,0.0,2.435993104267672,55.6261409189995,0.0,0.8810569437122501,0.2588340755455647,0.0,93.49600028991699,94.58000183105469,92.73999786376953,1.0115940953385854,0.9919140666573628,3.0,0.0,10845.4111328125,10856.5283203125,10689.6708984375,10787.6181640625,20759622009,10705.3396484375,11166.781504841027,10243.897792033975,0.0,0.0,8.620779378464198,51.67184917103007,-0.5642259453019216,-1.4342047687676627,-7.883177266425264,465187917741,10705.3396484375,11094.3466796875,10225.8642578125,1.036337663635621,0.9552115667161497,0.0,0.0,181
2020-10-01,1884.0999755859375,1909.5999755859375,1882.5,1908.4000244140625,730,1916.5799987792968,1983.842287426278,1849.3177101323156,0.0,0.0,7.018990982878018,49.77974644759826,1.1072860616721858,-2.448500905715147,-13.670411664941184,14225126,1916.5799987792968,1960.199951171875,1857.699951171875,1.022759265160004,0.9692785859995807,0.0,5.0,1.0051617238776698,1922.5,93.80000305175781,93.91999816894531,93.52999877929688,93.70999908447266,0.0,93.53900032043457,94.64132281719127,92.43667782367787,0.0,0.0,2.356925973081808,51.27289235738423,-0.1917140338118073,0.709291790509378,0.21829863751933942,0.0,93.53900032043457,94.58000183105469,92.73999786376953,1.0111290638883672,0.9914580821483241,3.0,0.0,10785.0107421875,10915.84375,10493.552734375,10623.330078125,27178227815,10716.460400390624,11158.324800077979,10274.59600070327,0.0,0.0,8.246461670707017,46.049185413930445,-1.5229319710703515,-4.245555102626082,-17.09742015480151,438009689926,10716.460400390624,11094.3466796875,10225.8642578125,1.0352622288683213,0.9542203186268255,0.0,0.0,182
2020-10-02,1893.9000244140625,1913.0,1893.9000244140625,1900.199951171875,530,1915.2099975585938,1982.6346301108845,1847.7853650063032,0.0,0.0,7.040964973892148,47.18738526898159,-0.42968314490067216,-3.0609122280678527,-12.045930865488572,14224596,1915.2099975585938,1960.199951171875,1857.699951171875,1.0234908723694174,0.9699719370408313,0.0,5.0,1.021667791939789,1888.5,93.7300033569336,94.02999877929688,93.69000244140625,93.83999633789062,0.0,93.59400024414063,94.63968358807357,92.5483169002077,0.0,0.0,2.2345093514654,54.152096388615156,0.13872292678265286,0.6758902044908576,0.1957669951634955,0.0,93.59400024414063,94.58000183105469,92.80000305175781,1.0105348802737575,0.9915165802261718,3.0,0.0,10624.390625,10662.8134765625,10440.3115234375,10585.1640625,23127839259,10723.61005859375,11151.909576167303,10295.310541020195,0.0,0.0,7.987972618051716,44.79110576365661,-0.35926602434758204,-3.2281830120911112,-26.926710915809963,414881850667,10723.61005859375,11094.3466796875,10225.8642578125,1.0345719975892491,0.953584119707676,0.0,0.0,183
2020-10-05,1898.9000244140625,1915.5999755859375,1884.699951171875,1912.5,1360,1914.6399963378906,1981.9537911592254,1847.3262015165558,0.0,0.0,7.031483197894654,51.40512603769022,0.6473028704447437,-1.4175257731958764,-9.569866290896016,14225956,1914.6399963378906,1960.199951171875,1857.699951171875,1.0237955724946342,0.9702607042185872,0.0,5.0,1.0236578440382738,1901.300048828125,93.80999755859375,93.87000274658203,93.37000274658203,93.51000213623047,0.0,93.62950019836425,94.61120152611286,92.64779887061565,0.0,0.0,2.096991494494297,46.41634703185279,-0.3516562388514388,0.5808335037507701,0.1471268962167045,0.0,93.62950019836425,94.58000183105469,92.93000030517578,1.0101517324206226,0.9925290651802423,3.0,0.0,10688.0341796875,10804.0009765625,10646.443359375,10804.0009765625,19385191766,10736.228955078124,11131.178249278862,10341.279660877386,0.0,0.0,7.357318772788118,54.147125680251044,1.119126430246986,5.653670967794306,-16.53206847639194,434719824920,10736.228955078124,11094.3466796875,10225.8642578125,1.0333560066674985,0.9524633184145884,0.0,0.0,184
2020-10-06,1906.5999755859375,1918.0,1874.4000244140625,1901.0999755859375,968,1913.0449951171875,1980.0540940752446,1846.0358961591303,0.0,0.0,7.005491154582319,47.49869361864131,-0.5960797079248348,-2.6125711099756543,-8.558238502421545,14224988,1913.0449951171875,1960.199951171875,1857.699951171875,1.0246491620296672,0.9710696590584258,0.0,5.0,1.0233622358587482,1903.199951171875,93.44000244140625,93.8499984741211,93.33999633789062,93.83000183105469,0.0,93.64700012207031,94.62989524740529,92.66410499673533,0.0,0.0,2.0991491965653104,53.563703419756635,0.34220905519606326,0.9684725308547968,0.1362785386050831,0.0,93.64700012207031,94.58000183105469,92.93000030517578,1.009962964192854,0.9923435901207737,3.0,0.0,10799.7783203125,10803.4560546875,10565.197265625,10621.6640625,22264958686,10718.56689453125,11100.625656231312,10336.508132831188,0.0,0.0,7.128915002526936,46.651605207292924,-1.6876795407372636,-1.152893794505392,-21.447959563152835,412454866234,10718.56689453125,11094.3466796875,10225.8642578125,1.035058771275475,0.9540327880054438,0.0,0.0,185
2020-10-07,1874.0999755859375,1889.800048828125,1873.0999755859375,1883.5999755859375,50,1909.9899963378907,1976.5172979476731,1843.4626947281083,0.0,0.0,6.966246078496555,42.048475316151894,-0.9205197109429464,-0.9257298568248491,-9.176328087534785,14224938,1909.9899963378907,1960.199951171875,1857.699951171875,1.0262880721523433,0.9726228696138337,0.0,5.0,1.0057667270804325,1900.800048828125,93.83000183105469,93.9000015258789,93.55999755859375,93.62999725341797,0.0,93.66549987792969,94.63235984443958,92.6986399114198,0.0,0.0,2.064495396426549,49.02263894048062,-0.213156318590757,0.09621160680968723,0.10857172103476387,0.0,93.66549987792969,94.58000183105469,92.93000030517578,1.0097634876695991,0.9921475935780789,3.0,0.0,10619.8037109375,10687.2685546875,10591.9638671875,10679.13671875,17634388529,10705.07421875,11072.4060208531,10337.7424166469,0.0,0.0,6.862760492771088,49.11839070045538,0.5410890036798399,-0.2163398695792418,-19.73961502887869,430089254763,10705.07421875,11094.3466796875,10225.8642578125,1.036363359373603,0.9552352509524725,0.0,0.0,186
2020-10-08,1893.0,1893.0,1882.699951171875,1888.5999755859375,348,1906.7099975585938,1970.6118822552082,1842.8081128619795,0.0,0.0,6.702842569497847,44.08527297844268,0.26544914338537673,-0.5267038938475622,-9.042077034306203,14225286,1906.7099975585938,1960.199951171875,1857.699951171875,1.0280535339311019,0.9742960143653346,0.0,5.0,0.9969909343318057,1906.4000244140625,93.61000061035156,93.77999877929688,93.5,93.61000061035156,0.0,93.67900009155274,94.6347797181366,92.72322046496888,0.0,0.0,2.0405419051223346,48.565248235983624,-0.02135709030545163,-0.40429541659181895,0.08445013856727712,0.0,93.67900009155274,94.58000183105469,92.93000030517578,1.0096179692206513,0.9920046137806237,3.0,0.0,10677.625,10939.7998046875,10569.8232421875,10923.6279296875,21962121001,10704.026318359374,11068.729255946379,10339.32338077237,0.0,0.0,6.814313170390316,58.24445731014327,2.2894286062302482,1.5732150536697063,3.0348853790274006,452051375764,10704.026318359374,11094.3466796875,10225.8642578125,1.036464817043532,0.9553287663608657,0.0,0.0,187
2020-10-09,1909.300048828125,1929.0999755859375,1905.0999755859375,1919.5,580,1905.7949951171875,1968.4009095726933,1843.1890806616816,0.0,0.0,6.570057599679677,54.9561550587359,1.6361338988408969,3.2044720040645034,-6.110796832918595,14225866,1905.7949951171875,1960.199951171875,1857.699951171875,1.0285471187583544,0.9747637893537677,0.0,5.0,1.016953642384106,1910.4000244140625,93.55999755859375,93.58999633789062,93.01000213623047,93.05999755859375,0.0,93.66549987792969,94.64787380954489,92.68312594631449,0.0,0.0,2.097621713214549,37.7898889671565,-0.5875473220507521,-1.40904951759174,0.01751225029296677,0.0,93.66549987792969,94.58000183105469,92.93000030517578,1.0097634876695991,0.9921475935780789,3.0,0.0,10925.4443359375,11105.849609375,10862.974609375,11079.4658203125,22593173917,10703.282275390626,11064.844144669913,10341.720406111339,1.0,0.0,6.756093317478938,62.95065945801387,1.426612949727768,2.8311395989472685,33.33383707052417,474644549681,10703.282275390626,11079.4658203125,10225.8642578125,1.0351465592743274,0.9553951764239814,1.0,0.0,188
2020-10-12,1924.0,1926.5,1921.5999755859375,1922.5,96,1904.2649963378906,1963.5810661836642,1844.948926492117,0.0,0.0,6.2298125481322115,55.88144904265854,0.15629070070330986,2.901030335350655,-3.575333188897048,14225962,1904.2649963378906,1960.199951171875,1857.699951171875,1.029373514159822,0.9755469720571637,0.0,5.0,1.0073883752911115,1924.5999755859375,93.05999755859375,93.23999786376953,93.01000213623047,93.06999969482422,0.0,93.66549987792969,94.64787380954489,92.68312594631449,0.0,0.0,2.097621713214549,38.06754658138689,0.01074805124958722,-1.3566494965529448,-0.031476430103012376,0.0,93.66549987792969,94.58000183105469,92.93000030517578,1.0097634876695991,0.9921475935780789,3.0,0.0,11392.6357421875,11698.4677734375,11240.6865234375,11555.36328125,26163972641,10818.12802734375,11416.588479967115,10219.667574720384,1.0,0.0,11.064029767640111,73.95552054493963,1.503679807902314,7.116910382916034,150.2198593620942,543655127968,10818.12802734375,11555.36328125,10225.8642578125,1.0681481354299769,0.9452526566487056,4.0,0.0,189
2020-10-13,1921.9000244140625,1922.199951171875,1887.0,1888.5,191,1900.8749938964843,1955.46991454037,1846.2800732525986,0.0,0.0,5.744188420509961,44.39693914896818,-1.768530559167747,1.6579668212132808,-4.580243942649304,14225771,1900.8749938964843,1960.199951171875,1857.699951171875,1.0312092891252067,0.9772867532777063,0.0,5.0,0.99384277893247,1901.0999755859375,93.02999877929688,93.5999984741211,93.02999877929688,93.52999877929688,0.0,93.68949966430664,94.63324720654087,92.7457521220724,0.0,0.0,2.014628204047884,49.569326899895906,0.4942506564746818,-1.1101744887184506,-0.027368970959486205,0.0,93.68949966430664,94.58000183105469,92.93000030517578,1.0095048235921715,0.9918934420415076,3.0,0.0,11548.7197265625,11548.984375,11321.224609375,11425.8994140625,24241420250,10878.12978515625,11467.600740127518,10288.658830184982,0.0,0.0,10.837726091035067,67.21260317623394,-1.1203790312466544,7.554781128283949,165.91293317648342,519413707718,10878.12978515625,11555.36328125,10565.4931640625,1.0622564272967094,0.9712600762016685,4.0,0.0,190
2020-10-14,1889.699951171875,1910.800048828125,1882.5,1901.300048828125,33,1897.929998779297,1945.280388411746,1850.579609146848,0.0,0.0,4.989687676879923,48.79860248251966,0.677789188674871,1.5217855220493732,-4.1365979970150875,14225804,1897.929998779297,1952.0999755859375,1857.699951171875,1.0285416094595066,0.9788031973606525,0.0,5.0,0.9941438163807189,1902.0,93.54000091552734,93.66999816894531,93.25,93.37999725341797,0.0,93.6979995727539,94.62727058648223,92.76872855902558,0.0,0.0,1.983545044644783,46.444154062921385,-0.16037798336003828,-0.9335931072234241,-0.03684160784347057,0.0,93.6979995727539,94.58000183105469,92.93000030517578,1.0094132453448585,0.9918034614284184,3.0,0.0,11429.0478515625,11539.9775390625,11307.8310546875,11429.5068359375,24103426719,10912.327685546876,11544.851052374073,10279.804318719678,0.0,0.0,11.592822082587569,67.3048955503669,0.03157232305546209,7.976662132510051,174.96926359663303,543517134437,10912.327685546876,11555.36328125,10565.4931640625,1.0589274455673476,0.9682162659077999,4.0,0.0,191
2020-10-15,1897.300048828125,1906.300048828125,1889.5999755859375,1903.199951171875,254,1896.0899963378906,1939.4500521670661,1852.7299405087151,0.0,0.0,4.573628457818051,49.458450352202426,0.09992648687517924,0.4698253768855555,-3.572061652571392,14226058,1896.0899963378906,1952.0999755859375,1857.699951171875,1.0295397261502484,0.9797530469333406,0.0,5.0,1.0011046108110597,1902.699951171875,93.43000030517578,93.9000015258789,93.37000274658203,93.86000061035156,0.0,93.74249954223633,94.6113356458478,92.87366343862486,0.0,0.0,1.8536653233147709,56.25110856253516,0.5140323099720678,-0.03195098465426385,-0.0016571374413558715,0.0,93.74249954223633,94.58000183105469,92.93000030517578,1.0089340725168205,0.9913326480408764,3.0,0.0,11426.6025390625,11569.9140625,11303.603515625,11495.349609375,24487233057,10951.9806640625,11625.000815994434,10278.960512130565,0.0,0.0,12.290382398872609,69.07052706684097,0.5760771167350187,8.80088066759928,184.3442026278426,568004367494,10951.9806640625,11555.36328125,10565.4931640625,1.0550934699115588,0.9647107211147471,4.0,0.0,192
2020-10-16,1898.5,1900.800048828125,1898.5,1900.800048828125,53,1893.525,1928.6076307519045,1858.4423692480957,0.0,0.0,3.7055365788045456,48.57975743084158,-0.1260982768664043,0.7046383485099338,-3.3000879961421106,14226005,1893.525,1922.5,1857.699951171875,1.0153021481100064,0.9810802345740748,0.0,5.0,1.0091314894166088,1908.800048828125,93.80000305175781,93.87999725341797,93.52999877929688,93.68000030517578,0.0,93.77999954223633,94.5661301953854,92.99386888908725,0.0,0.0,1.676542241387019,52.26350252024938,-0.19177530791101294,-0.22366501846607648,0.008832762493753421,0.0,93.77999954223633,94.58000183105469,93.05999755859375,1.0085306279880932,0.992322435624258,3.0,0.0,11502.828125,11540.0615234375,11223.0126953125,11322.123046875,25635480771,10980.36494140625,11665.441486386762,10295.288396425736,0.0,0.0,12.478210854306553,59.65343789631658,-1.506927308750361,5.968445793313228,173.09401437600536,542368886723,10980.36494140625,11555.36328125,10565.4931640625,1.0523660500276697,0.9622169409161171,4.0,0.0,193
2020-10-19,1907.300048828125,1907.800048828125,1899.5,1906.4000244140625,43,1893.7850036621094,1929.1671015152842,1858.4029058089345,0.0,0.0,3.7366541381154326,50.84400130454665,0.29461150263490055,-0.10479983097956946,-2.5567660959140994,14226048,1893.7850036621094,1922.5,1857.699951171875,1.0151627541048023,0.9809455390023393,0.0,4.0,1.0094249968538744,1876.199951171875,93.72000122070312,93.7699966430664,93.20999908447266,93.43000030517578,0.0,93.77449951171874,94.56876673847682,92.98023228496066,0.0,0.0,1.693994062125222,47.10982854669028,-0.26686592568914147,-0.29879285245161163,-0.005199956818231044,0.0,93.77449951171874,94.58000183105469,93.05999755859375,1.0085897799884849,0.9923806369871833,3.0,0.0,11495.0380859375,11799.0927734375,11408.2900390625,11742.037109375,23860769927,11092.31064453125,11859.778281131334,10324.843007931166,0.0,0.0,13.837831651035886,71.83398120446164,2.252631185070797,9.953055369717312,187.71902204050093,603643401163,11092.31064453125,11742.037109375,10565.4931640625,1.0585744923366422,0.9525060650254614,4.0,0.0,194
2020-10-20,1901.300048828125,1910.4000244140625,1896.0999755859375,1910.4000244140625,329,1894.3750061035157,1930.4454292915002,1858.3045829155312,0.0,0.0,3.808160799394908,52.50388816494349,0.20981955249552708,0.5367894697553801,-1.615921466811642,14226377,1894.3750061035157,1922.5,1857.699951171875,1.0148465820156347,0.9806400238529981,0.0,3.0,0.9952591947976361,1865.5999755859375,93.41999816894531,93.5,93.0,93.06999969482422,0.0,93.72849960327149,94.57252125681296,92.88447794973001,0.0,0.0,1.8009925628042704,40.6899564728608,-0.38531586126048234,-0.8205420642748871,-0.04666665544209536,0.0,93.72849960327149,94.58000183105469,93.05999755859375,1.0090847739096154,0.992867675813575,2.0,0.0,11745.974609375,11999.91796875,11681.48046875,11916.3349609375,30915821592,11148.746484375,11981.514321426817,10315.978647323183,0.0,0.0,14.93921918879299,75.42158319510395,1.4843919324981414,9.087704539552172,215.04796742157305,634559222755,11148.746484375,11916.3349609375,10565.4931640625,1.0688497561262404,0.947684403701355,4.0,0.0,195
2020-10-21,1913.5999755859375,1927.300048828125,1913.5999755859375,1924.5999755859375,1202,1897.6100036621094,1932.3118692558915,1862.9081380683274,0.0,0.0,3.6574286103901765,58.086531871054795,0.7432972670857296,0.6326784620098039,0.3379622599470622,14227579,1897.6100036621094,1924.5999755859375,1857.699951171875,1.0142231395659496,0.9789682535330159,0.0,2.0,1.0010923149991873,1877.4000244140625,93.05000305175781,93.06999969482422,92.47000122070312,92.61000061035156,0.0,93.63949966430664,94.55785700274365,92.72114232586964,0.0,1.0,1.9614742533423914,34.09366597900048,-0.4942506564746818,-0.962465517397524,-0.11638146294151852,0.0,93.63949966430664,94.58000183105469,92.61000061035156,1.0100438615127132,0.9890057181248748,1.0,1.0,11913.0771484375,13184.56640625,11900.9287109375,12823.689453125,43414712626,11258.764453125,12331.59284870285,10185.936057547151,1.0,0.0,19.057657703818002,85.84805501117843,7.614375520341321,15.742849529936127,310.113541595716,677973935381,11258.764453125,12823.689453125,10565.4931640625,1.138996157750297,0.9384238570805098,5.0,0.0,196
2020-10-22,1924.300048828125,1924.300048828125,1898.199951171875,1901.0999755859375,899,1899.25,1931.2512876938963,1867.2487123061037,0.0,0.0,3.369886817838231,47.763319598231824,-1.2210329573991374,0.0,-0.2561404749621943,14226680,1899.25,1924.5999755859375,1857.699951171875,1.013347361108826,0.9781229175579176,0.0,1.0,1.0066719489467502,1890.4000244140625,92.66999816894531,92.97000122070312,92.61000061035156,92.94999694824219,0.0,93.56949958801269,94.47387851616114,92.66512065986424,0.0,0.0,1.9330635134962453,41.83709623266118,0.367127022621605,-0.9378715396350412,-0.13653635243424844,0.0,93.56949958801269,94.58000183105469,92.61000061035156,1.010799483244981,0.9897456010571201,1.0,1.0,12801.6357421875,13161.59375,12717.09375,12965.8916015625,34729759598,11377.800830078126,12637.321077292152,10118.2805828641,1.0,0.0,22.13995948820591,86.82155153731802,1.1089019970212055,14.779363238681151,387.4287017089009,712703694979,11377.800830078126,12965.8916015625,10565.4931640625,1.1395780076661326,0.9286059161917982,6.0,0.0,197
2020-10-23,1899.9000244140625,1913.300048828125,1896.199951171875,1902.0,287,1901.4650024414063,1927.1688671174013,1875.7611377654114,0.0,0.0,2.703585355816932,48.155410503892455,0.04734229791283351,0.9768541437965748,-0.6135712866002905,14226967,1901.4650024414063,1924.5999755859375,1872.800048828125,1.0121669203034642,0.9849248060961013,0.0,0.0,1.0003681434565292,1908.5,92.93000030517578,93.12999725341797,92.66000366210938,92.7699966430664,0.0,93.47899932861328,94.32087704718674,92.63712161003983,0.0,0.0,1.8012125175066223,39.13251232720805,-0.19365283602538197,-0.9185097037052066,-0.16467638185865496,0.0,93.47899932861328,94.26000213623047,92.61000061035156,1.0083548477543247,0.9907038080798568,0.0,1.0,12971.548828125,13015.9619140625,12752.6474609375,12931.5390625,28974975002,11496.103125,12867.693906294222,10124.512343705777,1.0,0.0,23.861838509633625,85.24753148374508,-0.26494544392426933,13.592170879926762,434.97903413863605,683728719977,11496.103125,12965.8916015625,10621.6640625,1.1278510170430034,0.9239360457198404,7.0,0.0,198
2020-10-26,1895.5,1907.0,1893.5,1902.699951171875,242,1902.9599975585938,1925.0443296567869,1880.8756654604008,0.0,0.0,2.321050587140684,48.48951153243459,0.03680079768006994,0.7465834887328634,-0.8069364822981697,14227209,1902.9599975585938,1924.5999755859375,1883.5999755859375,1.0113717461507896,0.989826364191841,0.0,0.0,0.9997372845666099,1894.5999755859375,92.76000213623047,93.11000061035156,92.73999786376953,93.05000305175781,0.0,93.41849937438965,94.19884006869962,92.63815868007968,0.0,0.0,1.670634188165728,45.25002744984044,0.3018286286769367,-0.5982240732213225,-0.1584127945439775,0.0,93.41849937438965,93.88999938964844,92.61000061035156,1.0050471803595258,0.9913454104973587,0.0,1.0,13031.201171875,13225.2978515625,12822.3828125,13075.248046875,29461458313,11851.32265625,13427.950539500353,10274.694772999648,0.0,0.0,26.606783546119892,83.33037991268606,0.3382214014740148,14.399057059599798,502.52224880361246,713325575654,11851.32265625,13108.0625,10679.13671875,1.1060421591920153,0.9010923952119532,8.0,0.0,199
2020-10-27,1904.5999755859375,1908.800048828125,1904.4000244140625,1908.800048828125,176,1903.6849975585938,1925.5353412992895,1881.834653817898,0.0,0.0,2.2955839614976217,51.515083959623375,0.320602187039154,-0.557434288714509,-0.40795704251536336,14227385,1903.6849975585938,1924.5999755859375,1883.5999755859375,1.0109865750132856,0.9894493984044552,0.0,0.0,1.0042087541006388,1945.300048828125,93.06999969482422,93.12999725341797,92.79000091552734,92.94000244140625,0.0,93.37099952697754,94.14639366370837,92.59560539024672,0.0,0.0,1.6608885856615272,43.34830803617269,-0.11821666495849259,-0.1289438215511955,-0.16055689670001527,0.0,93.37099952697754,93.88999938964844,92.61000061035156,1.0055584696029836,0.9918497293540688,0.0,1.0,13075.2421875,13759.6689453125,13060.837890625,13654.21875,33749878155,12000.0767578125,13665.167518664013,10334.985996960986,0.0,0.0,27.75133516987676,88.03183087586456,4.427990207523247,18.780369575400652,549.6703666928988,747075453809,12000.0767578125,13654.21875,10923.6279296875,1.1378442842968144,0.910296504776589,8.0,0.0,200
2020-10-28,1870.9000244140625,1876.199951171875,1870.9000244140625,1876.199951171875,277,1903.1199951171875,1927.0961360980264,1879.1438541363486,0.0,1.0,2.5196667621962003,38.193839274016746,-1.7078843683110856,-2.408325036573472,-2.9280637124377336,14227108,1903.1199951171875,1924.5999755859375,1876.199951171875,1.0112867189267418,0.9858547837160132,0.0,1.0,0.984158585367481,1950.300048828125,93.1500015258789,93.6500015258789,93.05000305175781,93.44999694824219,0.0,93.34899940490723,94.08837481213614,92.60962399767833,0.0,0.0,1.5841099785586725,53.43054007527593,0.5487351984496236,0.40829188209302325,-0.11520851464445059,0.0,93.34899940490723,93.86000061035156,92.61000061035156,1.005474094084585,0.9920834845658043,0.0,1.0,13654.21484375,13837.6953125,12932.2509765625,13271.28515625,35867318894,12117.459619140625,13793.424427803395,10441.494810477856,0.0,0.0,27.66198297893118,72.9182661024107,-2.804507535445777,17.215517807969636,541.8996949063039,711208134915,12117.459619140625,13654.21875,11079.4658203125,1.1268218899968045,0.9143389925402747,8.0,0.0,201
2020-10-29,1876.0999755859375,1879.800048828125,1858.800048828125,1865.5999755859375,240,1900.9799926757812,1929.8332684999586,1872.1267168516038,0.0,1.0,3.0356211991020645,34.9305245840779,-0.5649704648652554,-1.212603887427191,-5.660641623371703,14226868,1900.9799926757812,1924.5999755859375,1865.5999755859375,1.012425161233238,0.981388537898264,0.0,2.0,0.9765493884759211,1853.199951171875,93.45999908447266,94.0999984741211,93.33999633789062,93.95999908447266,0.0,93.36149940490722,94.13263555421645,92.59036325559799,0.0,0.0,1.6519360854838547,61.11908664389331,0.5457486922262111,0.4597458684784705,-0.035487951377405125,0.0,93.36149940490722,93.95999908447266,92.61000061035156,1.0064105619916166,0.9919506563267968,0.0,1.0,13271.298828125,13612.0478515625,12980.0595703125,13437.8828125,56499499598,12235.38046875,13934.337204342992,10536.423733157008,0.0,0.0,27.77121218146414,74.99357035644438,1.2553242153156674,18.31099359831948,541.1878744295373,767707634513,12235.38046875,13654.21875,11296.361328125,1.115961925734456,0.9232537849539441,7.0,0.0,202
2020-10-30,1862.800048828125,1886.5999755859375,1862.800048828125,1877.4000244140625,725,1899.8399963378906,1930.4732208968496,1869.2067717789316,0.0,0.0,3.224821523708022,41.149932409106775,0.6325069137299355,-1.2570359122850383,-6.563790020400802,14227593,1899.8399963378906,1924.5999755859375,1865.5999755859375,1.0130326655380315,0.9819774187205481,0.0,2.0,0.9754754485240471,1875.4000244140625,93.91999816894531,94.08000183105469,93.6500015258789,94.04000091552734,0.0,93.37149963378906,94.17183202690366,92.57116724067446,0.0,0.0,1.7142969669622377,62.20662393890704,0.08514456346766508,0.7067934049282883,0.031067047519869107,0.0,93.37149963378906,94.04000091552734,92.61000061035156,1.0071595860017264,0.991844416910683,0.0,1.0,13437.8740234375,13651.5166015625,13136.1982421875,13546.5224609375,30581485200,12347.888525390625,14080.888529321397,10614.888521459852,0.0,0.0,28.069576435959103,76.30899435504719,0.808458072996765,17.96654636124283,540.6957539512041,798289119713,12347.888525390625,13654.21875,11322.123046875,1.1057938142155401,0.9169278637067081,6.0,0.0,203
2020-11-02,1872.9000244140625,1894.699951171875,1872.9000244140625,1890.4000244140625,190,1898.7349975585937,1929.0545924290768,1868.4154026881106,0.0,0.0,3.193662613210191,47.31421098423556,0.6924469921671284,-0.6725476611078663,-5.993154591008306,14227783,1898.7349975585937,1924.5999755859375,1865.5999755859375,1.013622215875623,0.9825488959674408,0.0,2.0,0.9943717051658069,1860.699951171875,93.88999938964844,94.29000091552734,93.88999938964844,94.05000305175781,0.0,93.39849967956543,94.25046958430586,92.546529774825,0.0,0.0,1.8243759967523987,62.35290546892212,0.010636044378031784,0.20243174959589244,0.08066306200457518,0.0,93.39849967956543,94.05000305175781,92.61000061035156,1.0069755228877078,0.9915576901993172,0.0,1.0,13737.0322265625,13808.3232421875,13243.16015625,13550.4892578125,30771455467,12683.04599609375,14460.28660530052,10905.80538688698,0.0,0.0,28.025453976184313,69.67117570281499,-1.3585108198026608,5.667634165223694,516.0585654180286,773370271064,12683.04599609375,13780.9951171875,11322.123046875,1.0865682519350564,0.8926974679711877,4.0,0.0,204
2020-11-03,1891.5,1908.5,1891.5,1908.5,712,1899.104998779297,1929.7102705444538,1868.49972701414,0.0,0.0,3.2231258181963907,54.661026021446474,0.9574680148212389,0.40509001336685296,-3.8998611342601635,14228495,1899.104998779297,1924.5999755859375,1865.5999755859375,1.0134247326098496,0.9823574666935764,0.0,2.0,1.0034174553101998,1872.5999755859375,94.05000305175781,94.05000305175781,93.29000091552734,93.55000305175781,0.0,93.38449974060059,94.21661785627197,92.55238162492921,0.0,0.0,1.7821332619070602,51.31988948877601,-0.5316320933289487,-0.13876734948172972,0.07269018853645548,0.0,93.38449974060059,94.05000305175781,92.61000061035156,1.0071264857980267,0.99170634171195,0.0,1.0,13550.451171875,13984.9814453125,13325.44140625,13950.30078125,29869951617,12809.085693359375,14570.322478904593,11047.848907814157,0.0,0.0,27.499804868325565,75.3660154916108,2.950532012761009,7.592298392876201,519.7578948548507,803240222681,12809.085693359375,13950.30078125,11322.123046875,1.0890941879233633,0.8839134437787967,4.0,0.0,205
2020-11-04,1893.800048828125,1907.0,1885.300048828125,1894.5999755859375,782,1899.6549987792969,1929.512168065221,1869.7978294933728,0.0,0.0,3.143430707692721,48.848655432110405,-0.7283219499115812,-0.6189702411356074,-3.486215517984192,14227713,1899.6549987792969,1924.5999755859375,1865.5999755859375,1.013131319541006,0.9820730484139263,0.0,2.0,0.9957429044022686,1885.699951171875,93.08999633789062,94.30000305175781,93.08999633789062,93.41000366210938,0.0,93.37350006103516,94.19812899023233,92.54887113183798,0.0,0.0,1.7663018493644176,48.64217559660924,-0.1496519348812675,-0.021402807450594096,0.05340832745349644,0.0,93.37350006103516,94.05000305175781,92.61000061035156,1.007245128331705,0.9918231677062066,0.0,1.0,13950.48828125,14218.7666015625,13580.4716796875,14133.70703125,35116364961,12941.003564453125,14684.01519780172,11197.99193110453,0.0,0.0,26.937812429576486,77.51771987594594,1.3147117963686394,9.296402871612948,529.3755517997743,838356587642,12941.003564453125,14133.70703125,11322.123046875,1.092164681112757,0.8749030158661781,4.0,0.0,206
